A	/阿/阿马米/蛾/峨/俄/娥/贺/我/芽/牙/雅/亚/娅/
A'Mer	/阿米尔/奥马尔/
Aab	/奥布/
Aaba	/阿巴/
Aabel	/奥贝尔/
Aabraek	/奥布赖克/
Aabrant	/阿布兰特/
Aaby	/奥比/
Aabye	/奥比/
Aach	/阿赫/
Aad	/阿德/
Aadahl	/奥达尔/
Aadalbert	/阿达尔贝特/
Aadasch	/阿达施/
Aadde	/奥德/
Aadel	/阿代勒/
Aadli	/奥德利/
Aadne	/奥德内/
Aadu	/阿杜/
Aae	/奥埃/
Aagaard	/埃格德/奥高/
Aage	/奥格/奥耶/
Aagje	/阿赫耶/
Aagot	/阿戈特/奥戈特/
Aague	/阿格/
Aahbshi	/阿卜希/
Aajav	/阿扎布/
Aakande	/奥坎德/
Aakenes	/奥克内斯/
Aakhus	/奥克许斯/
Aakjaer	/奥凯/
Aal	/阿尔/
Aalbano	/阿尔巴诺/
Aalberts	/奥尔贝茨/
Aalborg	/奥尔堡/
Aalefjaer	/奥勒菲耶尔/
Aalen	/奥伦/
Aalgaard	/奥尔高/
Aalim	/阿利姆/
Aalkjaer	/奥尔凯/
Aall	/奥尔/
Aalmo	/奥尔莫/
Aalrust	/奥尔鲁斯特/
Aalstad	/奥尔斯塔/
Aalto	/阿尔托/奥尔托/
Aaltoila	/阿尔托伊拉/
Aaltojarvi	/阿尔托耶维/
Aaltokoski	/阿尔托科斯基/
Aaltola	/阿尔托拉/
Aaltolahti	/阿尔托拉赫蒂/
Aaltomaa	/阿尔托马/
Aaltonen	/阿尔托宁/
Aalvik	/奥尔维克/
Aaly	/阿雷/
Aam	/奥姆/
Aama	/阿马/
Aamand	/奥曼/
Aamodt	/阿莫特/奥莫特/
Aamot	/奥莫特/
Aamuranta	/阿穆兰塔/
Aamurusko	/阿穆鲁斯科/
Aanaa	/阿纳/
Aandahl	/安达尔/
Aanerud	/奥内鲁德/
Aanesen	/奥内森/
Aang	/阿昂/
Aani	/阿尼/
Aanjesen	/奥尼耶森/
Aannecke	/安内克/
Aanni	/安尼/
Aano	/奥诺/
Aansel	/安泽尔/
Aansorge	/安佐格/
Aansprenger	/安斯普伦格/
Aant	/安特/
Aantaa	/安塔/
Aantjes	/安切斯/
Aanund	/奥农/
Aany	/阿尼/
Aapakari	/阿帕卡里/
Aapalahti	/阿帕拉赫蒂/
Aapasuo	/阿帕索/
Aapelt	/阿佩尔特/
Aapio	/阿皮奥/
Aapo	/阿波/
Aapola	/阿波拉/
Aapro	/阿普罗/
Aaqvist	/奥奎斯特/
Aara	/奥拉/
Aaraas	/奥罗斯/
Aarafi	/阿拉菲/
Aaraj	/阿拉杰/
Aarak	/奥拉克/
Aarao	/阿朗/
Aarbak	/奥尔巴克/
Aardal	/奥达尔/
Aardenne	/阿尔登纳/
Aare	/阿勒/阿雷/奥勒/
Aareharju	/阿雷哈留/
Aarek	/奥雷克/
Aarekorpi	/阿雷科皮/
Aarela	/阿雷拉/埃雷莱/
Aaremae	/奥雷梅埃/
Aarenstrup	/奥伦斯楚普/
Aaresalo	/阿雷萨洛/
Aarestad	/奥勒斯塔/
Aarestrup	/奥勒斯楚普/
Aarevaara	/阿雷瓦拉/
Aarevalta	/阿雷瓦尔塔/
Aarevuo	/阿雷沃/
Aarflot	/奥尔弗洛特/
Aari	/埃里/
Aariainen	/阿里艾宁/
Aarika	/阿里卡/
Aariki	/阿里基/
Aarikka	/阿里卡/
Aarila	/埃里莱/
Aarimaa	/埃里马/
Aario	/阿里奥/
Aarju	/阿尔久/
Aarmo	/阿尔莫/
Aarna	/阿尔纳/
Aarne	/阿尔内/
Aarnes	/奥尔内斯/
Aarni	/阿尔尼/
Aarnia	/阿尔尼亚/
Aarniaho	/阿尔尼亚霍/
Aarniala	/阿尔尼亚拉/
Aarniemi	/阿尔涅米/
Aarnikallio	/阿尔尼卡利奥/
Aarnikare	/阿尔尼卡雷/
Aarnikka	/阿尔尼卡/
Aarnikko	/阿尔尼科/
Aarnikoivu	/阿尔尼科伊武/
Aarnikorpi	/阿尔尼科皮/
Aarninsalo	/阿尔宁萨洛/
Aarnio	/阿尔尼奥/
Aarniokoski	/阿尼奥科斯基/
Aarniovuori	/阿尼奥沃里/
Aarnipalo	/阿尔尼帕洛/
Aarnipuu	/阿尔尼普/
Aarniva	/阿尔尼瓦/
Aarnivala	/阿尔尼瓦拉/
Aarnivirta	/阿尼维尔塔/
Aarnivuo	/阿尔尼沃/
Aarno	/阿尔诺/
Aarnount	/阿尔瑙特/
Aaro	/阿罗/
Aaroc	/奥勒克/
Aaroe	/奥勒埃/
Aarola	/阿罗拉/
Aaron	/阿龙/阿伦/
Aaronian	/阿罗尼安/
Aaronov	/阿罗诺夫/
Aaronovich	/阿罗诺维奇/
Aarons	/阿伦斯/
Aaronson	/阿龙松/阿伦森/
Aars	/阿尔斯/奥尔斯/
Aarsather	/奥尔塞特/
Aarseth	/奥塞特/
Aarskog	/奥斯科格/
Aarsse	/阿尔斯/
Aarstad	/奥尔斯塔/
Aarsten	/奥尔斯滕/
Aart	/阿尔特/
Aarted	/阿尔特德/
Aartelo	/阿尔泰洛/
Aarti	/阿尔蒂/
Aarto	/阿尔托/
Aartoaho	/阿尔托阿霍/
Aartola	/阿尔托拉/
Aartolahti	/阿尔托拉赫蒂/
Aartomaa	/阿尔托马/
Aarttamo	/阿尔塔莫/
Aarttila	/阿尔蒂拉/
Aarum	/奥鲁姆/
Aarva	/阿尔瓦/
Aarvala	/阿尔瓦拉/
Aarvik	/奥尔维克/
Aarvold	/阿沃尔德/
Aarynen	/埃吕宁/
Aas	/奥斯/
Aasa	/阿萨/奥莎/
Aasaki	/阿萨基/
Aasan	/奥桑/
Aasaroed	/奥萨勒德/
Aasbea	/奥斯贝亚/
Aasbo	/奥斯博/
Aase	/奥瑟/
Aasem	/阿西姆/
Aasen	/奥森/
Aaser	/奥瑟/
Aaseth	/奥塞特/
Aasgaard	/奥斯高/
Aashamar	/奥斯哈马尔/
Aasheim	/奥斯海姆/
Aasholm	/阿斯霍尔姆/
Aasland	/奥斯兰/
Aaslaug	/奥斯莱于格/
Aaslepp	/奥斯莱普/
Aasmund	/奥斯蒙/
Aaspegren	/阿斯佩格伦/
Aaspere	/奥斯佩勒/
Aass	/奥斯/
Aassen	/奥森/
Aastos	/阿托斯/
Aastrup	/奥斯特鲁普/
Aasulv	/奥叙尔/
Aasum	/奥叙姆/
Aasvold	/奥斯沃尔德/
Aata	/安安田/
Aatela	/阿泰拉/
Aatola	/阿托拉/
Aatolainen	/阿托莱宁/
Aatrala	/阿特拉拉/
Aatrokoski	/阿特罗科斯基/
Aattonen	/阿托宁/
Aaues	/奥耶斯/
Aav	/阿夫/
Aavaharju	/阿瓦哈留/
Aavakangas	/阿瓦坎加斯/
Aavakoski	/阿瓦科斯基/
Aavaluoma	/阿瓦卢奥马/
Aavaoja	/阿沃亚/
Aavasalo	/阿瓦萨洛/
Aavatsmark	/奥瓦茨马克/
Aavik	/阿维克/奥维克/
Aavikko	/阿维科/
Aaviksoo	/阿维克索/
Aavio	/阿维奥/
Aawar	/阿瓦尔/
Aawick	/阿威克/
Ab	/阿布/
Aba	/阿巴/阿瓦/奥鲍/英保/飨场/飨庭/
Aba'A	/阿巴阿/
Abaa	/阿巴阿/
Abaagu	/阿巴古/
Abaakil	/阿巴基勒/
Ababa	/阿巴巴/
Ababaker	/阿巴贝克尔/
Ababkov	/阿巴布科夫/
Ababou	/阿巴布/
Abac	/阿巴克/阿巴奇/
Abacal	/阿瓦卡尔/
Abacha	/阿巴查/
Abachin	/阿巴钦/
Abaci	/阿巴哲/
Abaco	/阿巴科/
Abacot	/阿巴科特/
Abad	/阿巴德/阿瓦德/奥巴德/
Abada	/阿巴达/阿瓦达/
Abadal	/阿瓦达尔/
Abadalejo	/阿瓦达莱霍/
Abadalla	/阿卜杜拉/
Abadan	/阿巴丹/
Abadanes	/阿瓦达内斯/
Abadantuono	/阿巴丹托诺/
Abadayev	/阿巴达耶夫/
Abade	/阿巴德/
Abadela	/阿卜杜拉/
Abadelli	/阿巴代利/
Abades	/阿瓦德斯/
Abadessa	/阿巴代萨/
Abadesso	/阿巴德索/
Abadi	/阿巴迪/奥鲍迪/
Abadia	/阿巴迪亚/阿瓦迪亚/
Abadias	/阿瓦迪亚斯/
Abadic	/阿巴迪奇/
Abadie	/阿巴迪/阿瓦迭/
Abadin	/阿瓦丁/
Abadir	/阿巴迪尔/
Abadji	/阿巴吉/
Abadjian	/阿巴吉安/
Abadjiev	/阿巴吉耶夫/
Abadou	/阿巴杜/
Abady	/阿巴迪/
Abadzhan	/阿巴占/
Abadzhiev	/阿巴吉耶夫/
Abadzhyan	/阿巴江/
Abadzic	/阿巴季奇/
Abadzijevic	/阿巴季耶维奇/
Abaelard	/阿贝拉尔/
Abaev	/阿巴耶夫/
Abaeva	/阿巴耶娃/
Abafa	/阿巴法/
Abafalvi	/奥鲍福尔维/
Abaffy	/奥鲍菲/
Abafi	/奥包菲/
Abaga	/阿巴加/
Abaginski	/阿巴金斯基/
Abagiu	/阿巴久/
Abagor	/阿巴戈尔/
Abaha	/阿巴哈/
Abahazi	/奥鲍哈齐/
Abahazy	/奥鲍哈齐/
Abai	/阿拜/奥鲍伊/
Abaidallah	/奥贝达拉/
Abaie	/阿叶家/
Abaigar	/阿瓦伊加尔/
Abailard	/阿贝拉尔/
Abaimov	/阿拜莫夫/
Abaisa	/阿瓦伊萨/
Abaishvili	/阿拜什维利/
Abaitiz	/阿瓦伊蒂斯/
Abaitov	/阿拜托夫/
Abaitua	/阿瓦伊图亚/
Abaja	/阿瓦哈/
Abajas	/阿瓦哈斯/
Abajo	/阿瓦霍/
Abak	/阿巴克/
Abaka	/阿巴卡/阿墓/
Abakanov	/阿巴卡诺夫/
Abakanowicz	/阿巴卡诺维奇/
Abakar	/阿巴卡尔/
Abakarov	/阿巴卡罗夫/
Abakeliya	/阿巴克利亚/
Abakhov	/阿巴霍夫/
Abakipov	/阿巴基罗夫/
Abakirov	/阿巴基罗夫/
Abakishin	/阿巴基申/
Abako	/阿巴科/
Abakov	/阿巴科夫/
Abakovski	/阿巴科夫斯基/
Abakovsky	/阿巴科夫斯基/
Abakshin	/阿巴克申/
Abakulov	/阿巴库洛夫/
Abakum	/阿巴库姆/
Abakumoski	/阿巴库莫夫斯基/
Abakumosky	/阿巴库莫夫斯基/
Abakumov	/阿巴库莫夫/
Abakumtsev	/阿巴库姆采夫/
Abakushin	/阿巴库申/
Abal	/阿巴尔/阿布/阿瓦尔/
Abala	/阿瓦拉/
Abalada	/阿巴拉达/
Abaladas	/阿巴拉达斯/
Abalain	/阿巴兰/
Abalakov	/阿巴拉科夫/
Abalan	/阿巴朗/
Abalate	/阿瓦拉特/
Abalayev	/阿巴利亚耶夫/
Abaldo	/阿巴尔多/
Abali	/阿巴勒/
Abalic	/阿巴利奇/
Abalikhin	/阿巴利欣/
Abalin	/阿巴林/
Abalishnikov	/阿巴利什尼科夫/
Abalita	/阿巴利塔/
Abaliyev	/阿巴利耶夫/
Abalkhail	/阿巴勒哈伊勒/
Abalkin	/阿巴尔金/
Aballain	/阿巴兰/
Aballazov	/阿巴拉佐夫/
Aballe	/阿瓦列/
Aballi	/阿瓦利/
Abally	/阿巴利/
Abalmasov	/阿巴利马索夫/
Abalo	/阿巴洛/阿瓦洛/
Abalos	/阿瓦洛斯/
Abalov	/阿巴洛夫/
Abalroado	/阿巴尔罗阿多/
Abalumovski	/阿巴卢莫夫斯基/
Abalumovsky	/阿巴卢莫夫斯基/
Abalux	/阿巴吕/
Abalyan	/阿巴良/
Abalyayev	/阿巴利亚耶夫/
Abamelek	/阿巴梅列克/
Abamon	/阿巴蒙/
Abamson	/阿万松/
Aban	/阿万/
Abana	/阿巴纳/
Abanadas	/阿瓦纳达斯/
Abanades	/阿瓦纳德斯/
Abanadez	/阿瓦纳德斯/
Abanarov	/阿巴纳罗夫/
Abanchev	/阿班切夫/
Abancourt	/阿邦古/
Abanda	/阿班达/
Abando	/阿万多/
Abane	/阿班/
Abangwu	/阿班古/
Abani	/阿巴尼/
Abanicos	/阿瓦尼科斯/
Abanin	/阿巴宁/
Abankin	/阿班金/
Abano	/阿巴诺/
Abanosa	/阿瓦诺萨/
Abanosimov	/阿巴诺西莫夫/
Abanovich	/阿巴诺维奇/
Abanoz	/阿巴诺兹/
Abanozoglu	/阿巴诺兹奥卢/
Abans	/阿万斯/
Abaouat	/阿巴瓦特/
Abapkov	/阿巴普科夫/
Abaque	/阿巴克/
Abarbanel	/阿巴伯内尔/阿瓦瓦内尔/
Abarca	/阿巴尔卡/阿瓦尔卡/
Abarcas	/阿瓦尔卡斯/
Abarco	/阿瓦尔科/
Abard	/阿巴德/
Abardia	/阿瓦尔迪亚/
Abare	/阿贝尔/
Abarenov	/阿巴列诺夫/
Abares	/阿瓦雷斯/
Abargudi	/阿巴尔朱迪/
Abari	/阿巴里/
Abarnou	/阿巴尔努/
Abaroa	/阿瓦罗亚/
Abarosquieta	/阿瓦罗斯基耶塔/
Abarquero	/阿瓦尔克罗/
Abarrategui	/阿瓦拉特吉/
Abarrio	/阿瓦里奥/
Abarshalin	/阿巴尔沙林/
Abartsumyan	/阿巴尔楚米扬/
Abaryan	/阿巴良/
Abaryshev	/阿巴雷舍夫/
Abarzua	/阿瓦苏亚/
Abarzuza	/阿瓦苏萨/
Abas	/阿巴斯/
Abas-Zade	/阿巴斯扎德/
Abasaliyev	/阿巴萨利耶夫/
Abasari	/奥鲍沙里/
Abascal	/阿巴斯卡尔/阿瓦斯卡尔/
Abashawul	/阿巴沙武尔/
Abasheli	/阿巴舍利/
Abashev	/阿巴舍夫/
Abashidze	/阿巴希泽/
Abashin	/阿巴申/
Abashkin	/阿巴什金/
Abashkov	/阿巴什科夫/
Abashvili	/阿巴什维利/
Abasi	/阿巴西/
Abasingh	/阿巴辛格/
Abasiyanik	/阿巴瑟亚纳克/
Abaskulu	/阿巴斯库卢/
Abasolo	/阿瓦索洛/
Abasota	/阿瓦索塔/
Abasov	/阿巴索夫/
Abasovic	/阿巴索维奇/
Abasovich	/阿巴索维奇/
Abass	/阿巴斯/
Abassi	/阿巴西/
Abassian	/阿巴西安/
Abassin	/阿巴森/
Abastante	/阿巴斯坦特/
Abastas	/阿瓦斯塔斯/
Abastecedora	/阿瓦斯特塞多拉/
Abastenia	/阿巴斯蒂尼亚/
Abat	/阿巴/阿巴特/
Abatangelo	/阿巴坦杰洛/
Abatantuono	/阿巴坦托诺/
Abatcha	/阿巴查/
Abate	/阿巴特/
Abatecola	/阿巴泰科拉/
Abategiovanni	/阿巴泰乔瓦尼/
Abatelli	/阿巴泰利/
Abatemattei	/阿巴泰马泰伊/
Abaterusso	/阿巴泰鲁索/
Abati	/阿巴蒂/
Abatianni	/阿巴蒂安尼/
Abatielos	/阿巴蒂洛斯/
Abatin	/阿巴京/
Abatini	/阿巴蒂尼/
Abatis	/阿巴蒂/阿巴蒂斯/
Abatista	/阿巴蒂斯塔/
Abattoirs	/阿巴图瓦尔/
Abaturin	/阿巴图林/
Abaturov	/阿巴图罗夫/
Abauhear	/阿包赫尔/
Abaulin	/阿包林/
Abaunza	/阿旺萨/
Abaurrea	/阿沃雷亚/
Abauzit	/阿博齐/
Abavari	/奥鲍瓦里/
Abavary	/奥鲍瓦里/
Abay	/阿巴伊/阿拜/奥鲍伊/
Abaya	/阿瓦亚/
Abayhan	/阿巴伊汗/
Abayi	/阿巴伊/
Abayifo	/阿巴伊福/
Abayji	/阿贝吉/
Abayoglu	/阿巴伊奥卢/
Abayomi	/阿巴约米/
Abaz	/阿巴兹/
Abaza	/阿巴扎/
Abazadze	/阿巴扎泽/
Abazhurov	/阿巴茹罗夫/
Abazi	/阿巴齐/
Abazin	/阿巴津/
Abaziou	/阿巴齐乌/
Abazovic	/阿巴佐维奇/
Abb	/阿布/
Abba	/阿巴/阿瓦/
Abbaadie	/阿巴迪/
Abbabban	/阿巴班/
Abbad	/阿巴德/阿瓦德/
Abbadessa	/阿巴代萨/阿巴德萨/
Abbadi	/阿巴迪/
Abbadia	/阿巴迪亚/
Abbadie	/阿巴迪/
Abbadini	/阿巴迪尼/
Abbado	/阿巴多/
Abbafati	/阿巴法蒂/
Abbagnale	/阿巴尼亚莱/
Abbagnano	/阿巴尼亚诺/
Abbagnara	/阿巴尼亚拉/
Abbai	/阿拜/
Abbakumov	/阿巴库莫夫/
Abbaleo	/阿巴莱奥/
Abballe	/阿巴莱/
Abbamondi	/阿巴蒙迪/
Abbamonte	/阿巴蒙特/
Abbamonti	/阿巴蒙蒂/
Abbandonati	/阿班多纳蒂/
Abbandonato	/阿班多纳托/
Abbandoni	/阿班多尼/
Abbaoui	/阿巴维/
Abbar	/阿巴尔/阿瓦/
Abbara	/阿巴拉/
Abbas	/阿巴斯/
Abbasali	/阿巴萨利/
Abbasaliev	/阿巴萨利耶夫/
Abbasaliyev	/阿巴萨利耶夫/
Abbasanta	/阿巴桑塔/
Abbasbhai	/阿巴斯巴伊/
Abbasciano	/阿巴夏诺/
Abbasi	/阿巴西/
Abbasoglu	/阿巴斯奥卢/
Abbasogly	/阿巴索格雷/
Abbasov	/阿巴索夫/
Abbasovich	/阿巴索维奇/
Abbass	/阿巴斯/
Abbassen	/阿巴桑/
Abbassi	/阿巴西/
Abbaszadegan	/阿巴萨德甘/
Abbat	/阿巴/
Abbatangeli	/阿巴坦杰利/
Abbatangelo	/阿巴坦杰洛/
Abbatantuono	/阿巴坦托诺/
Abbate	/阿巴特/
Abbatecola	/阿巴泰科拉/
Abbatelli	/阿巴泰利/
Abbatepaolo	/阿巴泰保罗/
Abbaterusso	/阿巴泰鲁索/
Abbatescianni	/阿巴泰希安尼/
Abbati	/阿巴蒂/
Abbatianni	/阿巴蒂安尼/
Abbaticchio	/阿巴蒂基奥/
Abbatiello	/阿巴蒂耶洛/
Abbatini	/阿巴蒂尼/
Abbatino	/阿巴蒂诺/
Abbatista	/阿巴蒂斯塔/
Abbatte	/阿瓦特/
Abbaye	/阿贝/
Abbayes	/阿贝/
Abbazia	/阿巴齐亚/
Abbdarani	/阿卜达拉尼/
Abbe	/阿贝/
Abbebe	/阿贝贝/
Abbeele	/阿贝勒/
Abbei	/阿贝伊/
Abbel	/阿贝尔/
Abbele	/阿贝莱/
Abbell	/阿贝尔/
Abbels	/阿贝尔斯/
Abbema	/阿贝马/
Abbenante	/阿贝南特/
Abbenda	/阿本达/
Abberger	/阿贝格尔/
Abberley	/阿伯利/
Abberud	/阿贝鲁德/
Abbes	/阿巴斯/阿贝斯/阿布/阿韦斯/
Abbesov	/阿别索夫/
Abbett	/阿贝特/
Abbey	/阿贝/阿比/
Abbeys	/阿贝/
Abbiati	/阿比亚蒂/
Abbid	/阿比德/
Abbie	/阿比/
Abbigliamento	/阿比利亚门托/
Abbina	/阿比纳/
Abbinanti	/阿比南蒂/
Abbink	/阿宾克/
Abbiso	/阿比索/
Abbiss	/阿比斯/
Abbitini	/阿比蒂尼/
Abbitt	/阿比特/
Abbo	/阿博/阿布/
Abbodi	/阿博迪/
Abbolito	/阿博利托/
Abbon	/阿邦/
Abbona	/阿博纳/
Abbonati	/阿博纳蒂/
Abbonato	/阿博纳托/
Abbond	/阿邦德/
Abbondandolo	/阿邦丹多洛/
Abbondante	/阿邦丹特/
Abbondanza	/阿邦丹扎/
Abbondanzieri	/阿邦丹齐耶里/
Abbondanzio	/阿邦丹齐奥/
Abbondati	/阿邦达蒂/
Abbondi	/阿邦迪/
Abbondio	/阿邦迪奥/
Abboni	/阿博尼/
Abbonizio	/阿博尼齐奥/
Abbonzio	/阿邦齐奥/
Abbonzo	/阿邦佐/
Abbor	/阿博尔/
Abbors	/阿博斯/
Abbos	/阿博斯/
Abbosh	/阿布什/
Abbot	/阿博特/阿沃特/
Abbott	/阿博特/阿沃特/
Abbouchi	/阿布希/
Abboud	/阿布德/
Abboudy	/阿布迪/
Abbozzo	/阿博佐/
Abbratozzato	/阿布拉托扎托/
Abbrescia	/阿布雷夏/
Abbro	/阿布罗/
Abbruciati	/阿布鲁恰蒂/
Abbrugi	/阿布鲁吉/
Abbrugiati	/阿布鲁贾蒂/
Abbruscato	/阿布鲁斯卡托/
Abbruzzese	/阿布鲁泽塞/
Abbruzzesi	/阿布鲁泽西/
Abbruzzetti	/阿布鲁泽蒂/
Abbruzzini	/阿布鲁齐尼/
Abbruzzo	/阿布鲁佐/
Abbshar	/阿布贝希尔/
Abbuhl	/阿布尔/
Abby	/阿比/
Abbyasov	/阿比亚索夫/
Abcarios	/阿布卡里奥斯/
Abcede	/阿夫塞德/
Abcilar	/阿布哲拉尔/
Abcioglu	/阿布哲奥卢/
Abd	/阿布德/
Abd-Al-khaiya	/阿卜杜勒－海亚/
Abd-Al-medzhid	/阿卜杜勒－马吉德/
Abd-Rashid	/阿布德－拉希德/
Abda	/阿夫达/
Abdaikl	/阿布代克尔/
Abdal	/阿卜杜勒/
Abdala	/阿卜杜拉/阿布达拉/阿夫达拉/
Abdalah	/阿卜杜拉/
Abdalasis	/阿卜杜勒－阿齐兹/
Abdalian	/阿卜杜利安/
Abdalin	/阿布达林/
Abdalla	/阿卜杜拉/阿布达拉/阿夫达利亚/
Abdallah	/阿卜杜拉/
Abdallahi	/阿卜杜拉希/
Abdallakh	/阿卜杜拉/
Abdalmunim	/阿卜杜勒－穆奈姆/
Abdaloff	/阿布达洛夫/
Abdalov	/阿布达洛夫/
Abdalwahhab	/阿卜杜勒－瓦哈卜/
Abdan	/阿卜丹/
Abdane	/阿卜丹/
Abdank	/阿布丹克/
Abdarrahman	/阿卜杜勒－拉赫曼/
Abday	/奥布道伊/
Abdeen	/阿卜丁/
Abdein	/阿卜丁/
Abdel	/阿卜杜勒/
Abdel-Ahad	/阿卜杜勒－阿哈德/
Abdel-Aziz	/阿卜杜勒－阿齐兹/
Abdel-Chadid	/阿卜杜勒－沙迪德/
Abdel-Daim	/阿卜杜勒－达耶姆/
Abdel-Emir	/阿卜杜勒－埃米尔/
Abdel-Fattah	/阿卜杜勒－法塔赫/
Abdel-Gabbar	/阿卜杜勒－贾巴尔/
Abdel-Ghaffar	/阿卜杜勒－加法尔/
Abdel-Ghani	/阿卜杜勒－加尼/
Abdel-Hadi	/阿卜杜勒－哈迪/
Abdel-Hak	/阿卜杜勒－哈克/
Abdel-Halim	/阿卜杜勒－哈利姆/
Abdel-Hamid	/阿卜杜勒－哈米德/
Abdel-Hay	/阿卜杜勒－哈伊/
Abdel-Hussein	/阿卜杜勒－侯赛因/
Abdel-Jabbar	/阿卜杜勒－贾巴尔/
Abdel-Jalil	/阿卜杜勒－贾利勒/
Abdel-Jawad	/阿卜杜勒－贾瓦德/
Abdel-Kader	/阿卜杜勒－卡德尔/
Abdel-Karim	/阿卜杜勒－卡里姆/
Abdel-Khalek	/阿卜杜勒－哈利克/
Abdel-Mawla	/阿卜杜勒－穆拉/
Abdel-Messih	/阿卜杜勒－迈西赫/
Abdel-Mir	/阿卜杜勒－米尔/
Abdel-Mounem	/阿卜杜勒－穆奈姆/
Abdel-Nabi	/阿卜杜勒－纳比/
Abdel-Rahim	/阿卜杜勒－拉希姆/
Abdel-Rahman	/阿卜杜勒－拉赫曼/
Abdel-Raouf	/阿卜杜勒－拉乌夫/
Abdel-Rashid	/阿卜杜勒－拉希德/
Abdel-Razzak	/阿卜杜勒－拉扎克/
Abdel-Rida	/阿卜杜勒－里达/
Abdel-Salam	/阿卜杜勒－萨拉姆/
Abdel-Salem	/阿卜杜勒－萨利姆/
Abdel-Salim	/阿卜杜勒－萨利姆/
Abdel-Samad	/阿卜杜勒－萨马德/
Abdel-Sater	/阿卜杜勒－萨塔尔/
Abdel-Sattar	/阿卜杜勒－萨塔尔/
Abdel-Wahab	/阿卜杜勒－瓦哈卜/
Abdel-Wahed	/阿卜杜勒－瓦希德/
Abdel-Wali	/阿卜杜勒－瓦利/
Abdela	/阿卜杜拉/
Abdelaadim	/阿卜杜拉迪姆/
Abdelaoui	/阿卜杜拉维/
Abdelateef	/阿卜杜勒阿提夫/
Abdelatif	/阿卜杜勒－拉蒂夫/
Abdelazeem	/阿卜杜勒－阿齐姆/
Abdelazim	/阿卜杜勒－阿齐姆/
Abdelaziz	/阿卜杜勒－阿齐兹/
Abdelbaki	/阿卜杜勒－巴基/
Abdelbasud	/阿卜杜勒－巴苏德/
Abdelemir	/阿卜杜勒－埃米尔/
Abdelgadir	/阿卜杜勒－卡迪尔/
Abdelghani	/阿卜杜勒－加尼/
Abdelhadi	/阿卜杜勒－哈迪/
Abdelhak	/阿卜杜勒－哈克/
Abdelhakim	/阿卜杜勒－哈基姆/
Abdelhamid	/阿卜杜勒－哈米德/
Abdelhaq	/阿卜杜勒－哈克/
Abdelio	/阿夫德略/
Abdeljaoued	/阿卜杜勒－贾维德/
Abdeljelil	/阿卜杜勒－贾利勒/
Abdelkader	/阿卜杜勒－卡德尔/
Abdelkarim	/阿卜杜勒－卡里姆/
Abdelkbir	/阿卜杜勒－克比尔/
Abdelkebir	/阿卜杜勒－克比尔/
Abdelkerim	/阿卜杜勒－卡里姆/
Abdelkrim	/阿卜杜勒－卡里姆/
Abdella	/阿卜杜拉/
Abdellah	/阿卜杜拉/
Abdellahi	/阿卜杜拉希/
Abdellaoui	/阿卜杜勒－拉维/
Abdellatif	/阿卜杜勒－拉蒂夫/
Abdellaziz	/阿卜杜勒－阿齐兹/
Abdelli	/阿卜杜利/
Abdelmadjid	/阿卜杜勒－马吉德/
Abdelmalak	/阿卜杜勒－马利克/
Abdelmalek	/阿卜杜勒－马利克/
Abdelmedjid	/阿卜杜勒－马吉德/
Abdelmoula	/阿卜杜勒－穆拉/
Abdelmoumene	/阿卜杜勒－穆迈奈/
Abdelnour	/阿卜杜勒－努尔/
Abdelouahab	/阿卜杜勒－瓦哈卜/
Abdeloughed	/阿卜杜勒－乌盖德/
Abdelouhed	/阿卜杜勒－乌希德/
Abdelwahab	/阿卜杜勒－瓦哈卜/
Abdelwahed	/阿卜杜勒－瓦希德/
Abdelzahab	/阿卜杜勒－扎哈卜/
Abdenego	/阿夫德内戈/
Abdeni	/阿卜德尼/
Abdennour	/阿卜杜努尔/
Abdenour	/阿卜杜努尔/
Abdenur	/阿卜杜努尔/
Abder	/阿卜杜勒/
Abderahim	/阿卜杜勒－拉希姆/
Abderahman	/阿卜杜拉赫曼/
Abderahmane	/阿卜杜拉赫曼/
Abderaman	/阿卜杜拉曼/
Abderamane	/阿卜杜拉曼/
Abderemane	/阿卜杜拉曼/
Abderhalden	/阿布德哈尔登/
Abderrahim	/阿卜杜勒－拉希姆/
Abderrahman	/阿卜杜勒－拉赫曼/
Abderrahmane	/阿卜杜勒－拉赫曼/
Abderramane	/阿卜杜拉曼/
Abderrazak	/阿卜杜勒－拉扎克/
Abderwahab	/阿卜杜勒－瓦哈卜/
Abdes	/阿夫德斯/
Abdeshlan	/阿夫德什兰/
Abdeslam	/阿卜杜勒－萨拉姆/
Abdessadek	/阿卜杜勒－萨迪克/
Abdessalam	/阿卜杜勒－萨拉姆/
Abdessalem	/阿卜杜勒/阿布萨拉姆/
Abdesselam	/阿卜杜勒－萨拉姆/
Abdi	/阿卜迪/
Abdian	/阿布迪恩/
Abdiano	/阿夫迪亚诺/
Abdias	/阿布迪亚斯/
Abdibekov	/阿布季别科夫/
Abdic	/阿布迪奇/
Abdigani	/阿卜迪加尼/
Abdija	/阿布迪亚/
Abdijevic	/阿布迪耶维奇/
Abdijoski	/阿布迪约斯基/
Abdijovski	/阿布迪约夫斯基/
Abdiju	/阿布迪尤/
Abdik	/阿布德克/
Abdikadirov	/阿卜迪卡迪罗夫/
Abdikadirovich	/阿卜迪卡迪罗维奇/
Abdikasim	/阿卜迪卡西姆/
Abdilah	/阿卜杜拉/
Abdilda	/阿布季尔达/
Abdildin	/阿布季尔金/
Abdillah	/阿卜杜拉/
Abdillahi	/阿卜杜拉希/
Abdille	/阿卜杜拉/
Abdilleh	/阿卜杜拉/
Abdimir	/阿布季米尔/
Abdimomunov	/阿布季莫穆诺夫/
Abdin	/阿卜丁/
Abdinabi	/阿布季纳比/
Abdine	/阿卜丁/
Abdiqasim	/阿卜迪卡西姆/
Abdir	/阿布季尔/
Abdirahman	/阿卜迪－拉赫曼/
Abdirakhmanov	/阿卜迪拉赫曼诺夫/
Abdirashid	/阿卜迪－拉希德/
Abdirhman	/阿卜迪－拉赫曼/
Abdirov	/阿布季罗夫/
Abdirzakov	/阿布季尔扎科夫/
Abdisalam	/阿卜迪－萨拉姆/
Abdiu	/阿布迪乌/
Abdivait	/阿布季瓦伊特/
Abdiya	/阿卜迪亚/
Abdiyev	/阿布季耶夫/
Abdnor	/阿布德诺/
Abdo	/阿卜杜/阿布多/
Abdo-Rabbo	/阿卜杜－拉布/
Abdol	/阿卜杜勒/
Abdol-Karim	/阿卜杜勒－卡里姆/
Abdol-Reza	/阿卜杜勒－礼萨/
Abdolalizadeh	/阿卜杜拉利扎德/
Abdolhossein	/阿卜杜勒－侯赛因/
Abdoll	/阿卜杜勒/
Abdollah	/阿卜杜拉/
Abdolov	/阿布多洛夫/
Abdolrahim	/阿卜杜勒拉希姆/
Abdolvahed	/阿卜杜勒瓦希德/
Abdon	/阿卜敦/阿布东/阿夫东/
Abdool	/阿卜杜勒/
Abdor	/阿卜杜勒/
Abdorreza	/阿卜杜勒－礼萨/
Abdou	/阿卜杜/
Abdou-Laye	/阿卜杜拉耶/
Abdouche	/阿卜杜什/
Abdoul	/阿卜杜勒/
Abdoul-Hamid	/阿卜杜勒－哈米德/
Abdoulaye	/阿卜杜拉耶/
Abdoulbar	/阿卜杜勒巴尔/
Abdoulbastu	/阿卜杜勒－巴斯图/
Abdoulkader	/阿卜杜勒－卡德尔/
Abdoulkarim	/阿卜杜勒－卡里姆/
Abdoulmajid	/阿卜杜勒－马吉德/
Abdoulmoumine	/阿卜杜勒－穆明/
Abdoulrahamane	/阿卜杜拉赫曼/
Abdoulwahab	/阿卜杜勒－瓦哈卜/
Abdoun	/阿卜敦/
Abdouni	/阿卜杜尼/
Abdourahamane	/阿卜杜拉赫曼/
Abdourahim	/阿卜杜拉希姆/
Abdourahmane	/阿卜杜拉赫曼/
Abdrabbo	/阿卜杜－拉布/
Abdraev	/阿布德拉耶夫/
Abdrahamane	/阿卜杜勒－拉赫曼/
Abdraimov	/阿布德赖莫夫/
Abdrakhimov	/阿布德拉希莫夫/
Abdrakhmanov	/阿布德拉赫曼诺夫/
Abdrakhmanovich	/阿布德拉赫曼诺维奇/
Abdrakmanov	/阿布德拉克马诺夫/
Abdramanov	/阿布德拉马诺夫/
Abdrashitov	/阿布德拉希托夫/
Abdrayev	/阿布德拉耶夫/
Abdrazyakov	/阿布德拉贾科夫/
Abdrezyakov	/阿布德列贾科夫/
Abdrikhimov	/阿布德里希莫夫/
Abdu	/阿卜杜/
Abdu-Dzhalil	/阿卜杜－贾利勒/
Abdual	/阿卜杜勒/
Abdualiev	/阿卜杜阿利耶夫/
Abdualim	/阿卜杜阿利姆/
Abduazimov	/阿卜杜阿齐莫夫/
Abdudzhalil	/阿卜杜贾利勒/
Abdugafar	/阿卜杜加法尔/
Abdugafur	/阿卜杜加富尔/
Abdugani	/阿卜杜加尼/
Abduganiyevich	/阿卜杜加尼耶维奇/
Abdugany	/阿卜迪加内/
Abdugulov	/阿卜杜古洛夫/
Abdukadir	/阿卜杜卡迪尔/
Abdukadirov	/阿卜杜卡迪罗夫/
Abdukadyrov	/阿卜杜卡迪罗夫/
Abdukadyrovich	/阿卜杜卡迪罗维奇/
Abdukarimov	/阿卜杜卡里莫夫/
Abdukhakim	/阿卜杜哈基姆/
Abdul	/阿卜杜勒/
Abdul-Aziz	/阿卜杜勒－阿齐兹/
Abdul-Baset	/阿卜杜勒－巴塞特/
Abdul-Hadi	/阿卜杜勒－哈迪/
Abdul-Halim	/阿卜杜勒－哈利姆/
Abdul-Jalil	/阿卜杜勒－贾利勒/
Abdul-Maged	/阿卜杜勒－马吉德/
Abdul-Mohsin	/阿卜杜勒－穆赫辛/
Abdul-Nabi	/阿卜杜勒－纳比/
Abdul-Rahim	/阿卜杜勒－拉希姆/
Abdul-Rahman	/阿卜杜勒－拉赫曼/
Abdul-Razzak	/阿卜杜勒－拉扎克/
Abdul-Salam	/阿卜杜勒－萨拉姆/
Abdul-Samad	/阿卜杜勒－萨马德/
Abdul-Wahab	/阿卜杜勒－瓦哈卜/
Abdul-Wahhab	/阿卜杜勒－瓦哈卜/
Abdula	/阿卜杜拉/
Abdulabekov	/阿卜杜拉别科夫/
Abduladzhanov	/阿卜杜拉贾诺夫/
Abdulaev	/阿卜杜拉耶夫/
Abdulah	/阿卜杜拉/
Abdulahi	/阿卜杜拉希/
Abdulahovic	/阿卜杜拉霍维奇/
Abdulai	/阿卜杜拉伊/
Abdulajanov	/阿卜杜拉贾诺夫/
Abdulakhad	/阿卜杜勒阿哈德/
Abdulakhatov	/阿卜杜拉哈托夫/
Abdulamin	/阿卜杜勒阿明/
Abdulatipov	/阿卜杜拉季波夫/
Abdulaye	/阿卜杜拉耶/
Abdulayev	/阿卜杜拉耶夫/
Abdulayevich	/阿卜杜拉耶维奇/
Abdulazhanov	/阿卜杜拉贾诺夫/
Abdulaziz	/阿卜杜勒阿齐兹/
Abdulcasim	/阿卜杜勒－卡西姆/
Abdulgamid	/阿卜杜勒哈米德/
Abdulganeyev	/阿卜杜勒加涅耶夫/
Abdulgani	/阿卜杜勒－加尼/
Abdulgapov	/阿卜杜勒加波夫/
Abdulghani	/阿卜杜勒－加尼/
Abdulhalim	/阿卜杜勒/
Abdulhaluk	/阿卜杜勒哈卢克/
Abdulhamid	/阿卜杜勒－哈米德/
Abduli	/阿卜杜利/
Abdulic	/阿卜杜利奇/
Abdulin	/阿卜杜林/
Abdulkader	/阿卜杜勒卡德尔/
Abdulkaderov	/阿卜杜勒卡德罗夫/
Abdulkadir	/阿卜杜勒/
Abdulkadyp	/阿卜杜勒卡迪尔/
Abdulkareem	/阿卜杜勒－卡里姆/
Abdulkerim	/阿卜杜勒/
Abdulkhafiz	/阿卜杜勒哈菲兹/
Abdulkhak	/阿卜杜勒哈克/
Abdulkhakov	/阿卜杜勒哈科夫/
Abdulkhalyk	/阿卜杜勒哈利克/
Abdulkhanov	/阿卜杜勒哈诺夫/
Abdulkhay	/阿卜杜勒哈伊/
Abdulkhayerov	/阿卜杜勒哈耶罗夫/
Abdulla	/阿卜杜拉/
Abdulla-Khan	/阿卜杜拉·汗/
Abdulladzhanov	/阿卜杜拉贾诺夫/
Abdullaev	/阿卜杜拉耶夫/
Abdullaeva	/阿卜杜拉耶娃/
Abdullah	/阿卜杜拉/
Abdullahe	/阿卜杜拉希/
Abdullahi	/阿卜杜拉希/
Abdullatif	/阿卜杜勒－拉蒂夫/
Abdullayev	/阿卜杜拉耶夫/
Abdullayevich	/阿卜杜拉耶维奇/
Abdullazhon	/阿卜杜拉琼/
Abdulle	/阿卜杜拉/
Abdulleh	/阿卜杜拉/
Abdullin	/阿卜杜林/
Abdulloyev	/阿卜杜洛耶夫/
Abdulmadzhid	/阿卜杜勒马吉德/
Abdulmalik	/阿卜杜－马利克/
Abdulmanov	/阿卜杜勒马诺夫/
Abdulmeawla	/阿卜杜勒－穆拉/
Abdulmejid	/阿卜杜勒－马吉德/
Abdulmenaf	/阿卜杜勒梅纳夫/
Abdulmenar	/阿卜杜勒梅纳尔/
Abdulmohsen	/阿卜杜勒－穆赫辛/
Abdulmoula	/阿卜杜勒－穆拉/
Abdulmughni	/阿卜杜勒－穆格尼/
Abdulmumini	/阿卜杜勒－穆米尼/
Abdulov	/阿卜杜洛夫/
Abdulovic	/阿卜杜洛维奇/
Abdulovski	/阿卜杜洛夫斯基/
Abdulqayyum	/阿卜杜勒－加尧姆/
Abdulrachman	/阿卜杜勒－拉赫曼/
Abdulragim	/阿卜杜勒拉希姆/
Abdulrahim	/阿卜杜勒－拉希姆/
Abdulrahman	/阿卜杜勒－拉赫曼/
Abdulrazak	/阿卜杜勒－拉扎克/
Abdulsalaam	/阿卜杜勒－萨拉姆/
Abdulsamed	/阿卜杜勒萨米德/
Abdulsemet	/阿卜杜勒/
Abdulvahap	/阿卜杜勒/
Abdulvakhitov	/阿卜杜勒瓦希托夫/
Abdulveliyev	/阿卜杜勒韦利耶夫/
Abdulwahab	/阿卜杜勒－瓦哈卜/
Abdulzhalilov	/阿卜杜勒扎利洛夫/
Abdumalik	/阿卜杜马利克/
Abdumomunov	/阿卜杜莫穆诺夫/
Abdunazarov	/阿卜杜纳扎罗夫/
Abdur	/阿卜杜勒/
Abduragim	/阿卜杜拉希姆/
Abduragimov	/阿卜杜拉希莫夫/
Abdurahim	/阿卜杜－拉希姆/
Abdurahman	/阿卜杜勒－拉赫曼/
Abdurahmanovic	/阿卜杜拉赫曼诺维奇/
Abdurakhim	/阿卜杜拉希姆/
Abdurakhimov	/阿卜杜拉希莫夫/
Abdurakhman	/阿卜杜拉赫曼/
Abdurakhmanov	/阿卜杜拉赫马诺夫/
Abdurakhmetov	/阿卜杜拉赫梅托夫/
Abdurakhmon	/阿卜杜拉赫蒙/
Abdurakhmonov	/阿卜杜拉赫莫诺夫/
Abdurashid	/阿卜杜勒－拉希德/
Abdurashidov	/阿卜杜拉希多夫/
Abdurashitov	/阿卜杜拉希托夫/
Abdurauf	/阿卜杜拉乌夫/
Abdurazak	/阿卜杜拉扎克/
Abdurazakov	/阿卜杜拉扎科夫/
Abdurazyk	/阿卜杜拉济克/
Abdurazzakov	/阿卜杜拉扎科夫/
Abdurehim	/阿不都热衣木/
Abdurekhmenova	/阿卜杜勒赫梅诺娃/
Abdurragim	/阿卜杜拉希姆/
Abdurrahim	/阿卜杜勒－拉希姆/
Abdurrahman	/阿卜杜勒/阿卜杜勒－拉赫曼/
Abdurrakhman	/阿卜杜拉赫曼/
Abdurrauf	/阿卜杜勒－拉乌夫/
Abdurreda	/阿卜杜勒－里达/
Abdus	/阿卜杜勒/阿卜杜什/
Abdusalam	/阿卜杜萨拉姆/
Abdusalamov	/阿卜杜萨拉莫夫/
Abdusalem	/阿卜杜勒－萨利姆/
Abdusalom	/阿卜杜萨洛姆/
Abdusamatov	/阿卜杜萨马托夫/
Abdusattar	/阿卜杜萨塔尔/
Abdusattarov	/阿卜杜萨塔罗夫/
Abdusattor	/阿卜杜萨托尔/
Abdushakhidov	/阿卜杜沙希多夫/
Abdushukurov	/阿卜杜舒库罗夫/
Abdussamad	/阿卜杜勒－萨马德/
Abduvakhid	/阿卜杜瓦希德/
Abduvali	/阿卜杜瓦利/
Abduvaliev	/阿卜杜瓦利耶夫/
Abduvaliyev	/阿卜杜瓦利耶夫/
Abduylla-Shaik	/阿卜杜勒－沙伊克/
Abduzhabar	/阿卜杜扎巴尔/
Abduzhapar	/阿卜杜扎帕尔/
Abdy	/阿卜迪/阿布迪/
Abdyev	/阿布季耶夫/
Abdygany	/阿卜迪加内/
Abdygaziyev	/阿卜迪加济耶夫/
Abdykaarovich	/阿卜迪卡罗维奇/
Abdykadyrov	/阿卜迪卡迪罗夫/
Abdykalikov	/阿布德卡雷科夫/
Abdykarimov	/阿卜迪卡里莫夫/
Abdykasym	/阿卜迪卡西姆/
Abdykrimov	/阿卜迪克里莫夫/
Abdykulob	/阿卜迪库洛夫/
Abdyl	/阿卜杜勒/
Abdyldakanov	/阿卜杜勒达卡诺夫/
Abdyldayev	/阿卜杜勒达耶夫/
Abdyle	/阿卜杜勒/
Abdymanap	/阿卜迪马纳普/
Abdyrazakov	/阿卜迪拉扎科夫/
Abdysh	/阿布德什/
Abdyzhapar	/阿卜迪扎帕尔/
Abe	/阿拜/阿贝/阿倍/阿闭/阿边/阿部/阿闲/安倍/安闭/安边/安部/安陪/
Abeal	/阿韦亚尔/
Abeasis	/阿贝亚西/
Abeau	/阿博/
Abeb	/阿贝卜/
Abebe	/阿贝贝/
Abebola	/阿贝博拉/
Abebora	/阿贝博拉/
Abeca	/阿贝卡/
Abecasis	/阿维卡西斯/
Abecassis	/阿贝卡西/阿贝卡西斯/
Abecera	/阿贝塞拉/
Abeche	/阿贝谢/
Abecia	/阿贝西亚/
Abeck	/阿贝克/
Abecourt	/阿伯古/
Abed	/阿贝/阿比德/
Abede	/阿贝德/
Abedenigo	/阿贝德尼戈/
Abedimovski	/阿贝迪莫夫斯基/
Abedin	/阿贝丁/
Abedine	/阿卜丁/
Abedji	/阿贝吉/
Abednigo	/阿贝德尼戈/
Abeed	/阿比德/
Abeel	/阿比尔/
Abefors	/阿贝福什/
Abegao	/阿贝冈/
Abeger	/阿伯热/阿维赫尔/
Abegg	/阿贝格/阿维格/
Abegglen	/阿贝格伦/
Abegoaria	/阿贝戈阿里亚/
Abegue	/阿贝格/
Abeguile	/阿贝吉莱/
Abegyan	/阿别吉扬/
Abehashihito	/阿闩/
Abehsera	/阿贝塞拉/
Abei	/阿贝伊/阿部井/安部井/
Abeid	/阿贝德/
Abeida	/奥贝达/
Abeidarrahmane	/阿卜杜勒－拉赫曼/
Abeiderrahmane	/阿卜杜勒－拉赫曼/
Abeidi	/阿贝迪/
Abeidy	/奥贝迪/
Abeigon	/阿韦贡/
Abeijon	/阿韦洪/
Abeilard	/阿贝拉尔/
Abeilhe	/阿贝耶/阿韦列/
Abeilhon	/阿贝永/
Abeilhou	/阿贝尤/
Abeillard	/阿贝亚尔/
Abeille	/阿贝耶/
Abeilles	/阿贝耶/
Abeillon	/阿贝永/
Abeir	/阿贝尔/
Abeito	/阿贝托/
Abejar	/阿韦哈尔/
Abejarro	/阿韦哈罗/
Abejer	/阿韦赫尔/
Abejon	/阿贝永/阿韦洪/
Abeka	/阿韦卡/
Abekassis	/阿伯卡西/
Abekawa	/阿部川/安部川/
Abekhzer	/阿贝克泽/
Abekzer	/阿贝克泽/
Abel	/阿拜尔/阿贝尔/阿韦尔/埃比勒/埃布尔/
Abela	/阿贝拉/阿韦拉/
Abelaira	/阿贝莱拉/阿韦莱拉/
Abelairas	/阿韦莱拉斯/
Abelane	/阿伯拉纳/
Abelanet	/阿贝拉内/
Abelard	/阿贝拉尔/
Abelardo	/阿贝拉尔多/阿韦拉多/
Abelart	/阿贝拉尔/
Abeldyayev	/阿别利佳耶夫/
Abele	/阿贝莱/阿贝勒/阿伯莱/埃伯利/
Abeleanu	/阿贝莱亚努/
Abeledo	/阿韦莱多/
Abeleen	/阿贝伦/
Abelein	/阿贝莱因/
Abelend	/阿伯朗/
Abelenda	/阿韦伦达/
Abeler	/阿贝勒尔/
Abeles	/阿伯勒/埃伯利斯/奥拜莱什/
Abelev	/阿别列夫/
Abelha	/阿贝利亚/
Abelheira	/阿贝列拉/
Abelho	/阿贝略/
Abeli	/阿贝利/阿别利/
Abelian	/阿别良/
Abelin	/阿贝林/阿伯兰/
Abeling	/阿贝林/
Abelite	/阿别利捷/
Abeliuk	/阿韦柳克/
Abelius	/阿贝柳斯/
Abelkhairov	/阿别利海罗夫/
Abelkhanov	/阿别利哈诺夫/
Abell	/阿伯尔/埃布尔/
Abella	/阿贝拉/阿韦利亚/奥拜洛/
Abellan	/阿贝朗/阿韦良/
Abellanas	/阿韦利亚纳斯/
Abellaneda	/阿韦利亚内达/
Abellard	/阿贝拉尔/
Abelleira	/阿贝莱拉/阿韦列拉/
Abelli	/阿贝利/阿韦利/
Abellio	/阿贝利奥/
Abello	/阿贝洛/阿韦略/
Abellon	/阿韦利翁/
Abelman	/阿贝尔曼/
Abelmann	/阿贝尔曼/
Abeloff	/阿贝洛夫/
Abelon	/阿伯隆/
Abeloos	/阿伯洛/
Abelous	/阿布卢斯/
Abelov	/阿别洛夫/
Abelovich	/阿别洛维奇/
Abelovszki	/奥拜洛夫斯基/
Abelovszky	/奥拜洛夫斯基/
Abelow	/阿比洛/
Abels	/阿贝尔斯/埃布尔斯/
Abelsberg	/阿贝尔斯贝格/
Abelsen	/阿贝尔森/
Abelski	/阿别利斯基/
Abelsky	/阿别利斯基/
Abelson	/阿贝尔松/埃布尔森/
Abelsson	/阿贝尔松/
Abelsted	/阿贝尔斯泰德/
Abelt	/阿贝尔特/
Abely	/阿贝利/
Abelya	/阿别利娅/
Abelyan	/阿别良/
Abelyashev	/阿别利亚舍夫/
Abelyuk	/阿别柳克/
Aben	/阿边/阿文/
Abenante	/阿贝南特/
Abenavoli	/阿贝纳沃利/
Abencerrages	/阿文塞拉赫斯/
Abencerrajes	/阿文塞拉赫斯/
Abend	/阿本德/阿文德/
Abendano	/阿文达尼奥/
Abendanon	/阿本达农/
Abendoh	/阿本多/
Abendorff	/阿本多夫/
Abendroth	/阿本德罗思/阿本德罗特/
Abendschein	/阿本德沙因/
Abenesdra	/阿贝内斯德拉/
Abenezra	/阿韦内斯拉/
Abeng	/阿本/
Abengoa	/阿文戈亚/
Abengochea	/阿文戈切亚/
Abengoza	/阿文戈萨/
Abengozar	/阿文戈萨尔/
Abeni	/阿贝尼/
Abenia	/阿韦尼亚/
Abeniacar	/阿伯尼亚卡/阿韦尼亚卡/
Abenius	/阿贝尼乌斯/
Abeno	/阿倍野/阿部/阿部野/安部野/
Abenoja	/阿韦诺哈/
Abenojar	/阿韦诺哈/
Abenokadoudo	/阿闭门人/
Abenoroth	/阿贝诺罗特/
Abenouchi	/阿倍内/
Abenov	/阿别诺夫/
Abensera	/阿文塞拉/
Abensour	/阿邦苏尔/
Abenspero	/阿文斯佩罗/
Abent	/奥本特/
Abente	/阿文特/
Abenza	/阿文萨/
Abeodu	/阿贝奥杜/
Abeozen	/阿贝奥藏/
Aber	/阿贝/阿韦尔/
Abera	/阿贝拉/阿韦拉/
Aberani	/阿贝拉尼/
Aberard	/阿贝拉尔/
Aberasturi	/阿韦拉斯图里/
Aberbour	/阿贝布尔/
Aberconway	/阿伯康韦/
Abercorn	/阿伯康/
Abercrombie	/阿伯克龙比/
Abercromby	/阿伯克龙比/
Abercron	/阿贝尔克龙/
Aberdare	/阿伯代尔/
Aberdeen	/阿伯丁/
Aberdour	/阿伯道尔/
Abere	/阿贝雷/
Aberen	/阿贝伦/
Aberfeld	/阿贝费尔德/
Aberg	/阿韦尔格/奥贝里/
Abergavenny	/阿伯加文尼/
Abergel	/阿贝热尔/阿韦尔赫尔/
Aberhart	/埃伯哈特/
Aberich	/阿贝里希/
Aberico	/阿贝里科/
Aberik	/阿贝里克/
Aberils	/阿贝里尔斯/
Aberjoux	/阿贝茹/
Aberkane	/阿贝尔坎/
Aberkov	/阿别尔科夫/
Aberle	/阿贝莱/阿贝勒/阿伯利/
Aberlen	/阿贝朗/
Aberlenc	/阿贝朗/
Aberlic	/阿贝尔利奇/
Abermann	/阿贝尔曼/
Abern	/阿本/
Abernathy	/阿伯内西/
Abernethy	/阿伯内西/
Abernibesov	/阿别尔尼别索夫/
Abernot	/阿贝诺/
Abernu	/阿贝努/
Abero	/阿韦罗/
Abersfeller	/阿伯斯费勒/
Abersten	/阿贝尔斯滕/
Abert	/阿贝尔/阿贝特/艾伯特/奥贝尔特/
Aberturar	/阿韦尔图拉尔/
Aberturas	/阿韦尔图拉斯/
Aberuthven	/阿伯里文/
Abesadze	/阿别萨泽/
Abesamis	/阿韦萨米斯/
Abescat	/阿贝斯卡/
Abeselom	/阿贝塞洛姆/
Abeshiro	/阿部城/
Abeslam	/阿布萨拉姆/
Abeso	/阿贝索/
Abeson	/阿韦松/
Abesser	/阿贝塞尔/
Abessira	/阿贝西拉/
Abessol	/阿贝索尔/
Abessole	/阿贝索莱/
Abet	/阿贝特/奥拜特/
Abete	/阿贝特/阿韦特/
Abetelli	/阿贝泰利/
Abeti	/阿贝蒂/
Abetini	/阿贝蒂尼/
Abetone	/阿贝托内/
Abetono	/阿贝托诺/
Abetsedarski	/阿别采达尔斯基/
Abetsedarsky	/阿别采达尔斯基/
Abette	/阿贝特/
Abetti	/阿贝蒂/
Abety	/阿贝蒂/
Abetyan	/阿别强/
Abetz	/阿贝茨/
Abeuov	/阿别沃夫/
Abey	/阿拜/
Abeyagunawardene	/阿贝古纳瓦德纳/
Abeyasekera	/阿贝塞克拉/
Abeydeera	/阿贝迪拉/
Abeygoonewardena	/阿贝古纳瓦德纳/
Abeyratne	/阿贝拉特纳/
Abeysekara	/阿贝塞克拉/
Abeysinghe	/阿贝辛哈/
Abeysundera	/阿贝孙德拉/
Abeytua	/阿韦图亚/
Abeywadana	/阿贝瓦德纳/
Abeywickrema	/阿贝维克勒马/
Abeywickreme	/阿贝维克勒马/
Abezash	/阿贝扎什/
Abezgauz	/阿别兹高兹/
Abezguz	/阿别兹古兹/
Abezis	/阿伯齐/
Abezuela	/阿韦苏埃拉/
Abgar	/阿布加尔/
Abgarov	/阿布加罗夫/
Abgarovich	/阿布加罗维奇/
Abgaryan	/阿布加良/
Abgrall	/阿布格拉尔/
Abguar	/阿布瓜尔/阿夫瓜尔/
Abgueguen	/阿布格冈/
Abhamon	/阿巴蒙/
Abhay	/阿沛/
Abhayawardena	/阿巴亚瓦德纳/
Abhayawardhana	/阿巴亚瓦德纳/
Abherve	/阿贝尔韦/
Abhisit	/阿比西/
Abhyankar	/阿比安卡尔/
Abi	/阿比/阿维/
Abi-Ad	/阿比阿德/
Abi-Assi	/阿比－阿西/
Abi-Chahla	/阿比－沙赫拉/
Abi-Daher	/阿比－达希尔/
Abi-Farah	/阿比－法拉赫/
Abi-Faraj	/阿比－法拉杰/
Abi-Fares	/阿比－法拉斯/
Abi-Ghanem	/阿比－加奈姆/
Abi-Hachem	/阿比－哈希姆/
Abi-Haidar	/阿比－海达尔/
Abi-Haila	/阿比－哈伊拉/
Abi-Hanna	/阿比－汉纳/
Abi-Hassan	/阿比－哈桑/
Abi-Hatab	/阿比－哈塔卜/
Abi-Hatem	/阿比－哈特姆/
Abi-Jaber	/阿比－贾比尔/
Abi-Jeries	/阿比/
Abi-Kanaan	/阿比－卡纳安/
Abi-Karam	/阿比－卡拉姆/
Abi-Khalil	/阿比－哈利勒/
Abi-Kharas	/阿比－哈拉斯/
Abi-Khater	/阿比－哈特尔/
Abi-Khattar	/阿比－哈塔尔/
Abi-Kheir	/阿比－海尔/
Abi-Kherse	/阿比－赫尔斯/
Abi-Mansour	/阿比－曼苏尔/
Abi-Marouan	/阿比－马尔万/
Abi-Merhi	/阿比－迈尔希/
Abi-Mourched	/阿比－穆尔希德/
Abi-Nader	/阿比－纳迪尔/
Abi-Nahed	/阿比－纳希德/
Abi-Nassif	/阿比－纳西夫/
Abi-Rached	/阿比－拉希德/
Abi-Rafeh	/阿比－拉菲/
Abi-Saab	/阿比－萨阿卜/
Abi-Saad	/阿比－萨阿德/
Abi-Saada	/阿比－萨阿达/
Abi-Sarkis	/阿比－萨尔基斯/
Abi-Tayeh	/阿比－塔伊/
Abi-Waked	/阿比－瓦克德/
Abi-Warde	/阿比－瓦尔德/
Abi-Yaghi	/阿比－亚吉/
Abi-Yared	/阿比－亚里德/
Abi-Younes	/阿比－尤尼斯/
Abia	/阿维亚/
Abiad	/阿比阿德/
Abian	/阿维安/
Abianda	/阿维安达/
Abiants	/阿比安茨/
Abiathar	/阿拜亚撒/
Abib	/阿比布/
Abibi	/阿比比/
Abibon	/阿比邦/
Abibos	/阿比博斯/
Abicaran	/阿比卡朗/
Abich	/阿比希/
Abicht	/阿比希特/
Abid	/阿比德/
Abida	/阿比达/
Abidar	/阿比达尔/
Abidat	/阿比达特/
Abidi	/奥贝迪/
Abidia	/阿比迪亚/
Abidin	/阿比丁/
Abidine	/阿比丁/
Abidini	/阿比迪尼/
Abidinov	/阿比季诺夫/
Abidinpasa	/阿比丁帕夏/
Abido	/阿比杜/
Abidoh	/阿比多/
Abidon	/阿比东/
Abidor	/阿比多尔/
Abidov	/阿比多夫/
Abidri	/阿比德里/
Abidulin	/阿比杜林/
Abidulov	/阿比杜洛夫/
Abiduyev	/阿比杜耶夫/
Abidy	/阿比迪/
Abie	/阿比/
Abieda	/阿维达/
Abiega	/阿维加/
Abiel	/埃比尔/
Abienzo	/阿温索/
Abietar	/阿维塔尔/
Abigail	/阿比盖尔/阿维盖尔/
Abignente	/阿比年特/
Abignoli	/阿比尼奥利/
Abignoly	/阿比尼奥利/
Abihassira	/阿比阿西拉/
Abihssira	/阿比西拉/
Abijah	/阿拜贾/
Abiken	/阿比肯/
Abiker	/阿比克/
Abiki	/安引/罗曳/网引/
Abiko	/阿比古/阿孙/阿彦/阿珥古/安孙子/安彦/我孙/我孙古/我孙子/我彦/吾孙/吾孙子/吾彦/
Abikobe	/阿比古部/
Abil	/阿维尔/
Abild	/阿比尔/阿比尔德/
Abildua	/阿维尔杜瓦/
Abile	/阿比勒/
Abileah	/阿比莱亚/
Abilev	/阿比列夫/
Abilevich	/阿比列维奇/
Abilgaliyevich	/阿比尔加利耶维奇/
Abilio	/阿比利奥/阿维略/
Abillama	/阿比拉马/
Abillard	/阿比亚尔/
Abillio	/阿比利奥/
Abillon	/阿比永/
Abilov	/阿比洛夫/
Abilsiitov	/阿比尔西托夫/
Abim	/阿比姆/
Abimael	/阿维马埃尔/
Abimaola	/阿比马奥拉/
Abimbola	/阿宾博拉/
Abin	/阿宾/
Abinal	/阿比纳尔/
Abingdon	/阿宾登/
Abinger	/阿宾杰/
Abiniente	/阿比尼恩特/
Abinir	/阿比尼尔/
Abino	/阿比野/阿维诺/
Abinun	/阿比南/阿比农/
Abinzano	/阿温萨诺/
Abio	/阿维奥/
Abiola	/阿比奥拉/
Abion	/阿比翁/
Abioseh	/阿比奥塞/
Abiprix	/阿比普里/
Abir	/阿比尔/
Abira	/安平/安蒜/蛤良/
Abirached	/阿比拉谢/
Abire	/阿毗缘/
Abirsitov	/阿比尔西托夫/
Abiru	/阿比留/阿毗留/阿蒜/阿蛭/畔蒜/
Abis	/阿比什/阿比斯/
Abisai	/阿比萨伊/
Abisel	/阿比塞尔/
Abisgil	/阿伯什吉尔/
Abish	/阿比什/
Abishakaev	/阿比沙卡耶夫/
Abishev	/阿比舍夫/
Abishevich	/阿比舍维奇/
Abishkin	/阿比什金/
Abisnor	/阿比斯诺尔/
Abisov	/阿比索夫/
Abisoye	/阿比索耶/
Abissino	/阿比西诺/
Abisso	/阿比索/
Abisti	/阿比斯蒂/
Abit	/阿比/阿比特/
Abita	/阿比塔/
Abitabile	/阿比塔比莱/
Abitante	/阿比坦特/
Abitare	/阿比塔雷/
Abitbol	/阿维特沃尔/
Abitini	/阿比蒂尼/
Abitov	/阿比托夫/
Abittan	/阿比唐/
Abitz	/阿比茨/
Abiusi	/阿比乌西/
Abiuso	/阿比乌索/
Abivain	/阿比万/
Abiven	/阿比旺/
Abivon	/阿比冯/
Abiya	/阿比娅/
Abiye	/阿比耶/
Abiyev	/阿比耶夫/
Abiyu	/阿比尤/
Abizanda	/阿维桑达/
Abizov	/阿比佐夫/
Abizu	/会津/
Abjac	/阿布雅克/
Abjak	/阿比亚克/
Abjat	/阿布雅/
Abjornsson	/奥比约恩松/
Abjta	/阿比塔/
Abk	/阿卜克/
Abkar	/阿卜卡尔/阿布卡尔/
Abkaryan	/阿布卡良/
Abkhasi	/阿布卡西/
Abkim	/阿布坎/
Abkin	/阿布金/阿布坎/
Abkine	/阿布金/
Abkowitz	/阿布科维茨/
Abla	/阿卜拉/阿夫拉/
Ablaevich	/阿布拉耶维奇/
Ablaikhan	/阿布莱汉/
Ablak	/阿布拉克/
Ablamov	/阿布拉莫夫/
Ablamovich	/阿布拉莫维奇/
Ablamowicz	/阿布拉莫维奇/
Ablanque	/阿夫兰克/
Ablard	/阿布拉德/阿布拉尔/
Ablas	/阿布拉斯/
Ablasse	/阿布拉塞/
Ablava	/阿布拉瓦/
Ablaykhan	/阿布莱汉/
Ablazov	/阿布拉佐夫/
Able	/阿布勒/埃布尔/
Ableiges	/阿布莱热/
Ableiter	/阿布莱特/
Abler	/阿布勒/埃布勒/
Ables	/埃布尔斯/
Ablesimov	/阿布列西莫夫/
Ablesov	/阿布列索夫/
Ablets	/阿布列茨/
Abletshauser	/阿布勒茨豪泽/
Abletsov	/阿布列佐夫/
Ablewhite	/埃布尔怀特/
Ablewicz	/阿布莱维奇/
Ablichenkov	/阿布利琴科夫/
Ablin	/阿布兰/埃布林/
Ablisimov	/阿布利西莫夫/
Abliyev	/阿布利耶夫/
Ablogin	/阿布洛金/
Ablomov	/阿布洛莫夫/
Ablon	/阿布隆/
Ablonczay	/奥布隆曹伊/
Ablonczi	/奥布隆齐/
Ablonczy	/奥布隆齐/
Ablondi	/阿布隆迪/
Ablov	/阿布洛夫/
Abluch	/阿布卢奇/
Ablum	/阿布卢姆/
Ablyakimov	/阿布利亚基莫夫/
Ablyayev	/阿布利亚耶夫/
Ablyazov	/阿布利亚佐夫/
Abman	/阿布曼/
Abmeier	/阿布迈尔/
Abmoramov	/阿布莫拉莫夫/
Abmorshev	/阿布莫尔舍夫/
Abmosov	/阿布莫索夫/
Abner	/阿布纳/阿布内/
Abnett	/阿布尼特/
Abney	/阿布尼/
Abnizov	/阿布尼佐夫/
Abnodi	/阿布诺季/
Abnody	/阿布诺季/
Abnor	/阿布诺/
Abnosov	/阿布诺索夫/
Abo	/阿保/阿博/安保/安房/禾生/英保/
Aboaf	/阿博阿夫/
Aboal	/阿沃阿尔/
Abobora	/阿博博拉/
Aboche	/阿布什/
Abod	/奥博德/
Abodah	/阿布达/
Abodi	/阿博迪/
Abody	/奥博迪/
Aboev	/阿博耶夫/
Abogabir	/阿沃加维尔/
Abogacia	/阿沃加西亚/
Abogo	/阿博戈/
Abohe	/阿博赫/
Aboim	/阿博因/
Aboimov	/阿博伊莫夫/
Aboin	/阿博因/阿沃因/
Aboitiz	/阿沃伊蒂斯/
Abokar	/阿布卡尔/
Aboker	/阿布卡尔/
Aboklic	/阿博克利奇/
Abol	/阿博尔/阿博利/阿布/
Abolafia	/阿沃拉菲亚/
Abolafio	/阿博拉菲奥/
Abolakin	/阿博拉金/
Abolduyev	/阿博尔杜耶夫/
Abolesci	/阿博莱希/
Abolfazi	/阿布法齐/
Abolghasem	/阿布卡西姆/
Aboli	/阿沃利/
Abolikhin	/阿博利欣/
Abolin	/阿博林/
Abolins	/阿博林斯/
Abolishin	/阿博利申/
Abolits	/阿博利茨/
Abolivier	/阿博利维耶/
Abollado	/阿沃利亚多/
Abollo	/阿沃略/
Abollolabra	/阿沃略拉夫拉/
Abolmaali	/阿布马利/
Abolmasov	/阿博尔马索夫/
Abolmazov	/阿博尔马佐夫/
Abolnik	/阿博尔尼克/阿博利尼克/
Abolonkov	/阿博隆科夫/
Abolonski	/阿博隆斯基/
Abolonsky	/阿博隆斯基/
Abolshasov	/阿博尔沙索夫/
Aboltib	/阿博尔季布/
Aboltin	/阿博尔京/
Abolyanin	/阿博利亚宁/
Abolyayev	/阿博利亚耶夫/
Abolyn	/阿博伦/
Abon	/阿邦/阿翁/
Abonal	/阿博纳尔/
Abondance	/阿邦当斯/
Abondaram	/阿邦达朗/
Abondo	/阿邦多/
Abonisimov	/阿博尼西莫夫/
Abonizio	/阿博尼齐奥/
Abonnat	/阿博纳/
Abonnear	/阿博内亚尔/
Abonneau	/阿博诺/
Abonnel	/阿博内尔/
Abonnenc	/阿博南/
Abonos	/阿沃诺斯/
Abonosimov	/阿博诺西莫夫/
Abony	/阿博尼/
Abonyi	/奥博尼/
Aboo	/阿布/
Abood	/阿布德/
Abool	/阿布/
Aboosally	/阿布萨利/
Abord	/阿博尔/
Abordo	/阿沃多/
Aborenkov	/阿博连科夫/
Aboressi	/阿博雷西/
Aborin	/阿博林/
Aborn	/阿博恩/
Aborshev	/阿博尔舍夫/
Abos	/阿博/阿沃斯/奥博什/
Abosally	/阿博萨利/
Abosek	/阿沃塞克/
Aboshi	/安星/网干/
Aboshin	/阿博申/
Aboshiya	/网干屋/
Abosinelli	/阿博西内利/
Abotchi	/阿博奇/
Abou	/阿布/阿沃/
Abou-Abbas	/阿布－阿巴斯/
Abou-Abboud	/阿布－阿布德/
Abou-Abdallah	/阿布－阿卜杜拉/
Abou-Akde	/阿布－阿克德/
Abou-Akl	/阿布－阿克勒/
Abou-Alafahd	/阿布－阿拉法赫德/
Abou-Alamir	/阿布－阿拉米尔/
Abou-Alfa	/阿布－阿勒法/
Abou-Ali	/阿布－阿里/
Abou-Alouan	/阿布－阿勒万/
Abou-Ammo	/阿布－阿穆/
Abou-Aoude	/阿布－奥德/
Abou-Aoun	/阿布－奥恩/
Abou-Arbid	/阿布－阿尔比德/
Abou-Arrage	/阿布－阿拉杰/
Abou-Asly	/阿布－阿斯利/
Abou-Assad	/阿布－阿萨德/
Abou-Assaf	/阿布－阿萨夫/
Abou-Assi	/阿布－阿西/
Abou-Ata	/阿布－阿塔/
Abou-Atallah	/阿布－阿塔拉/
Abou-Atme	/阿布－阿特梅/
Abou-Ayache	/阿布－阿亚希/
Abou-Azar	/阿布－阿扎尔/
Abou-Aziz	/阿布－阿齐兹/
Abou-Azzam	/阿布－阿扎姆/
Abou-Badra	/阿布－巴德拉/
Abou-Bakr	/阿布－贝克尔/
Abou-Barake	/阿布－巴拉凯/
Abou-Berghol	/阿布－贝古尔/
Abou-Boutros	/阿布－布特罗斯/
Abou-Chaaban	/阿布－沙班/
Abou-Chaar	/阿布－沙尔/
Abou-Chabab	/阿布－沙巴卜/
Abou-Chabke	/阿布－沙卜凯/
Abou-Chacr	/阿布－沙克尔/
Abou-Chacra	/阿布－沙克拉/
Abou-Chahine	/阿布－沙欣/
Abou-Chahla	/阿布－沙赫拉/
Abou-Chaia	/阿布－沙亚/
Abou-Chaker	/阿布－沙克尔/
Abou-Chala	/阿布－沙拉/
Abou-Chalache	/阿布－沙拉什/
Abou-Chale	/阿布－沙莱/
Abou-Cham	/阿布－沙姆/
Abou-Chanab	/阿布－沙纳卜/
Abou-Charaf	/阿布－谢拉夫/
Abou-Chaya	/阿布－沙亚/
Abou-Chebel	/阿布－谢卜勒/
Abou-Chebli	/阿布－谢卜利/
Abou-Chehade	/阿布－谢哈德/
Abou-Chelah	/阿布－谢拉赫/
Abou-Chirouch	/阿布－希鲁什/
Abou-Dabbeh	/阿布－达贝/
Abou-Daher	/阿布－达希尔/
Abou-Dames	/阿布－达迈斯/
Abou-Daoud	/阿布－达乌德/
Abou-Dargham	/阿布－达尔加姆/
Abou-Darwiche	/阿布－达尔维什/
Abou-Daye	/阿布－达耶/
Abou-Debs	/阿布－德卜斯/
Abou-Dehn	/阿布－德恩/
Abou-Diab	/阿布－迪亚卜/
Abou-Diwan	/阿布－迪万/
Abou-Elias	/阿布－埃利亚斯/
Abou-Jaoude	/阿布－贾乌德/
Abouab	/阿布阿/
Abouaf	/阿布阿夫/
Abouah	/阿布瓦/
Aboubacar	/阿布－巴卡尔/
Aboubacary	/阿布巴卡里/
Aboubakar	/阿布－巴克尔/阿布巴卡尔/
Aboubakary	/阿布巴卡里/
Aboubakr	/阿布－贝克尔/
Aboubekr	/阿布贝克尔/
Aboucaya	/阿布卡亚/
Abouchaer	/阿布－沙伊尔/
Abouchar	/阿布沙尔/
Abouchard	/阿布沙尔/
Abouchdid	/阿布－什迪德/
Aboud	/阿博德/阿布德/
Aboudi	/阿布迪/
Aboudou	/阿布杜/
Aboudrahamane	/阿布德拉赫曼/
Abouem	/阿布埃姆/
Aboufadel	/阿布－法德勒/
Abougit	/阿布吉/
Abouhamad	/阿布－哈马德/
Abouhatsera	/阿布哈采拉/
Aboujaber	/阿布－贾比尔/
Abouka	/阿布卡/
Aboul	/阿布/
Aboulaye	/阿布莱/
Aboulin	/阿布兰/
Aboulrahamane	/阿布拉赫曼/
Abouly	/阿布利/
Abounalala	/阿布纳拉拉/
Abouo	/阿布奥/
Abouphele	/阿布费勒/
Abouraliame	/阿布拉利亚姆/
Abourd	/阿布尔/
Abourezk	/阿布雷兹克/
Abourjeily	/阿布尔杰利/
Aboushaer	/阿布－沙伊尔/
Aboussouan	/阿布苏安/
About	/阿布/
Abouticari	/阿布蒂卡里/
Abouyoub	/阿布尤布/
Abouzit	/阿布齐/
Abov	/阿博夫/
Abovic	/阿博维奇/
Abovich	/阿博维奇/
Aboville	/阿博维尔/
Abovski	/阿博夫斯基/
Abovsky	/阿博夫斯基/
Abovyan	/阿博维扬/
Aboy	/阿沃伊/
Aboyan	/阿博扬/
Aboyantz	/阿博扬茨/
Aboymasov	/阿博伊马索夫/
Aboyne	/阿博因/
Abozin	/阿博津/
Abozovich	/阿博佐维奇/
Abozzi	/阿博齐/
Abpech	/阿布佩奇/
Abplanalp	/阿普拉纳尔普/
Abra	/阿布拉/
Abraamian	/阿布拉米扬/
Abraamyan	/阿布拉米扬/
Abraao	/阿布拉昂/
Abrabanel	/阿夫拉瓦内尔/
Abraben	/阿布拉边/
Abrache	/阿卜拉什/
Abraches	/阿布拉什/阿布拉谢斯/
Abracos	/阿布拉索斯/
Abradushkin	/阿布拉杜什金/
Abrafile	/阿布拉菲勒/
Abragam	/亚伯拉罕/
Abragamcon	/亚伯拉罕松/
Abragao	/阿布拉冈/
Abragin	/阿布拉金/
Abraha	/阿布拉哈/
Abrahall	/阿布拉霍尔/
Abraham	/阿夫拉姆/亚伯拉罕/
Abrahamova	/亚伯拉罕莫娃/
Abrahamovicova	/亚伯拉罕莫维乔娃/
Abrahams	/阿夫拉姆斯/亚伯拉罕斯/
Abrahamsen	/亚伯拉罕森/亚伯拉罕松/
Abrahamson	/亚伯拉罕森/亚伯拉罕松/
Abrahamsson	/亚伯拉罕松/
Abrahamyan	/亚伯拉罕米扬/
Abrahan	/阿夫拉安/亚伯拉罕/
Abrahao	/阿布拉昂/
Abrahin	/阿夫拉因/
Abrahmi	/阿布拉米/
Abraimov	/阿布赖莫夫/
Abrain	/阿夫拉因/
Abraitis	/阿布赖季斯/
Abrak	/阿布拉克/
Abrakhimov	/阿布拉希莫夫/
Abrakhin	/阿布拉欣/
Abrakimov	/阿布拉基莫夫/
Abrakji	/阿卜拉吉/
Abrakov	/阿布拉科夫/
Abraldes	/阿夫拉尔德斯/
Abralychev	/阿布拉雷切夫/
Abram	/阿布拉姆/阿布兰/阿夫拉姆/艾布拉姆/
Abramavichius	/阿布拉马维丘斯/
Abramavichus	/阿布拉马维丘斯/
Abramchenko	/阿布拉姆琴科/
Abramchev	/阿布拉姆切夫/
Abramchuk	/阿布拉姆丘克/
Abramcuk	/阿布拉姆丘克/
Abramcukova	/阿布拉姆丘科娃/
Abramenko	/阿布拉缅科/
Abramenkov	/阿布拉缅科夫/
Abrami	/阿布拉米/
Abramian	/阿布拉米安/阿布拉米扬/
Abramichev	/阿布拉米切夫/
Abramin	/阿布拉曼/
Abramkin	/阿布拉姆金/
Abramo	/阿布拉莫/阿夫拉莫/
Abramochkin	/阿布拉莫奇金/
Abramoff	/阿布拉莫夫/
Abramoshvili	/阿布拉莫什维利/
Abramov	/阿布拉莫夫/
Abramova	/阿布拉莫娃/
Abramovay	/阿布拉莫瓦伊/
Abramovic	/阿布拉莫维奇/
Abramovich	/阿布拉莫维奇/
Abramovits	/阿布拉莫维茨/
Abramovitz	/阿布拉莫维茨/
Abramovski	/阿布拉莫夫斯基/
Abramovsky	/阿布拉莫夫斯基/
Abramow	/阿布拉莫夫/
Abramowitz	/阿布拉莫维茨/
Abramowski	/阿布拉莫夫斯基/
Abrams	/阿布拉姆斯/艾布拉姆斯/
Abramski	/阿布拉姆斯基/
Abramsky	/阿布拉姆斯基/
Abramson	/阿布拉姆松/艾布拉姆森/
Abramsson	/阿布拉姆松/
Abramtsev	/阿布拉姆采夫/
Abramunin	/阿布拉穆宁/
Abramushkin	/阿布拉穆什金/
Abramy	/阿布拉米/
Abramyan	/阿布拉米扬/
Abramyants	/阿布拉米扬茨/
Abramychev	/阿布拉梅切夫/
Abramyuk	/阿布拉缪克/
Abran	/阿布兰/
Abranches	/阿布兰谢斯/
Abrand	/阿布朗/
Abrander	/阿布兰德/
Abranin	/阿布拉宁/
Abranko	/奥布龙科/
Abrante	/阿布兰特/
Abrantes	/阿布兰特斯/阿布朗泰斯/阿夫兰特斯/
Abranyi	/阿布拉尼/
Abrar	/阿布拉尔/
Abrard	/阿布拉尔/
Abras	/阿布拉什/阿夫拉斯/
Abrash	/阿卜拉什/
Abrashchin	/阿布拉辛/
Abrashin	/阿布拉申/
Abrashkin	/阿布拉什金/
Abrashkov	/阿布拉什科夫/
Abrashkovich	/阿布拉什科维奇/
Abrashov	/阿布拉绍夫/
Abrasifs	/阿布拉西夫/
Abrasimov	/阿布拉西莫夫/
Abrassart	/阿布拉萨尔/
Abrat	/阿布拉/
Abratakov	/阿布拉塔科夫/
Abrate	/阿布拉泰/阿布拉特/
Abrati	/阿布拉蒂/
Abratis	/阿布拉蒂斯/
Abraul	/阿布劳尔/
Abravanel	/阿布拉瓦内尔/
Abray	/阿布劳伊/阿布雷/
Abrayev	/阿布拉耶夫/
Abraz	/阿布拉兹/
Abrazevich	/阿布拉泽维奇/
Abrazhanov	/阿布拉扎诺夫/
Abrazhevich	/阿布拉热维奇/
Abrazumov	/阿布拉祖莫夫/
Abre	/阿布雷/
Abrefa	/阿布雷法/
Abrego	/阿夫雷戈/
Abregu	/阿夫雷古/
Abreha	/阿布拉哈/
Abrelle	/阿布雷勒/
Abresch	/阿布雷施/
Abrescia	/阿布雷夏/
Abress	/阿布雷斯/
Abreu	/阿布勒/阿布雷乌/阿夫雷乌/
Abrezyakov	/阿布列贾科夫/
Abrham	/阿布尔哈姆/
Abrhamova	/阿布尔哈莫娃/
Abri	/阿布里/
Abrial	/阿布里亚尔/
Abriani	/阿布里亚尼/
Abriany	/阿布里亚尼/
Abrias	/阿布里亚/
Abriat	/阿布里亚/
Abribat	/阿布里巴/阿布里巴特/
Abric	/阿布里克/
Abriel	/阿布里埃尔/
Abrieu	/阿布里厄/
Abrieux	/阿布里厄/
Abrigeon	/阿布里容/
Abrignani	/阿布里尼亚尼/
Abrihan	/阿布里汉/
Abrikosov	/阿布里科索夫/
Abril	/阿布里尔/阿夫里尔/
Abrile	/阿布里勒/
Abrimont	/阿布里蒙/
Abrines	/阿夫里内斯/
Abring	/阿布林/
Abrini	/阿布里尼/
Abrino	/阿布里诺/
Abrio	/阿夫里奥/
Abriol	/阿布里奥尔/
Abriou	/阿布里乌/
Abrioux	/阿布里乌/
Abrisqueta	/阿夫里斯克塔/
Abrizi	/阿布里齐/
Abrlic	/阿布尔利奇/
Abro	/阿卜鲁/
Abrodes	/阿夫罗德斯/
Abromont	/阿布罗蒙/
Abronzino	/阿布龙齐诺/
Abrorov	/阿布罗罗夫/
Abroshchenko	/阿布罗先科/
Abroshin	/阿布罗申/
Abrosim	/阿布罗西姆/
Abrosimov	/阿布罗西莫夫/
Abrosin	/阿布罗辛/
Abroskin	/阿布罗斯金/阿布罗西金/
Abrosov	/阿布罗索夫/
Abrot	/阿布罗/
Abrouk	/阿卜鲁克/
Abrudbannay	/奥布鲁德班瑙伊/
Abrue	/阿布吕埃/
Abruggia	/阿布鲁贾/
Abrugia	/阿布鲁贾/
Abrukin	/阿布鲁金/
Abruna	/阿夫鲁尼亚/
Abrunedo	/阿夫鲁涅多/
Abrunheiro	/阿布鲁涅罗/
Abrunhosa	/阿布鲁尼奥萨/
Abrusan	/奥布鲁尚/
Abrusca	/阿布鲁斯卡/
Abrusci	/阿布鲁希/
Abruscia	/阿布鲁夏/
Abrutin	/阿布鲁京/
Abruzzese	/阿布鲁泽塞/
Abruzzesi	/阿布鲁泽西/
Abruzzetti	/阿布鲁泽蒂/
Abruzzi	/阿布鲁齐/
Abruzzini	/阿布鲁齐尼/
Abruzzo	/阿布鲁佐/
Abry	/阿布里/
Abryadin	/阿布里亚金/
Abryakhimov	/阿布里亚希莫夫/
Abryandin	/阿布良金/
Abryarov	/阿布里亚罗夫/
Abryutin	/阿布留京/
Abs	/阿卜斯/阿布斯/
Absa	/阿卜萨/
Absakine	/阿布萨金/
Absaliamov	/阿布萨利亚莫夫/
Absalon	/阿布萨隆/阿夫萨隆/
Absalonsen	/阿布萨隆森/
Absalyamov	/阿布萨利亚莫夫/
Absamat	/阿布萨马特/
Absan	/阿布桑/
Absatarov	/阿布萨塔罗夫/
Abse	/阿布斯/
Abselyam	/阿布谢利亚姆/
Abser	/阿夫塞尔/
Absey	/阿布谢伊/
Abshagen	/阿布斯哈根/
Abshir	/阿卜希尔/
Abshire	/阿布希尔/
Absi	/阿卜西/
Abside	/阿布西德/
Absie	/阿卜西/
Absil	/阿布西/
Absire	/阿布西尔/
Abskulu	/阿布斯库卢/
Absmeier	/阿布斯迈尔/
Absolom	/阿布索隆/
Absolon	/阿布索隆/
Absolonova	/阿布索隆诺娃/
Absy	/阿卜西/
Abszenger	/奥布森格/
Abszinger	/奥布辛格/
Abszolon	/奥布索隆/
Abt	/阿布特/
Abtallah	/阿卜塔拉/
Abtan	/阿布唐/
Abthorpe	/阿布索普/
Abtmeyer	/阿布特迈尔/
Abu	/阿布/阿武/安保/
Abu-Bakar	/阿布－巴卡尔/
Abu-Bekr-Kelevi	/阿布－贝克尔－凯莱维/
Abu-Eid	/阿布－艾德/
Abu-L-ala	/阿布阿拉/
Abu-L-ula	/阿布－乌拉/
Abu-Qasim	/阿布－卡西姆/
Abu-Said	/阿布－赛义德/
Abuashar	/阿布阿沙尔/
Abuawad	/阿瓦瓦德/
Abubakar	/阿布巴卡尔/
Abubakarov	/阿布巴卡罗夫/
Abubaker	/阿布·贝克尔/阿布－贝克尔/阿武瓦克/
Abubakir	/阿布巴基尔/
Abubakirov	/阿布巴基罗夫/
Abubakr	/阿布·贝克尔/阿布－贝克尔/阿布巴克尔/
Abubikirov	/阿布比基罗夫/
Abubyakirov	/阿布比亚基罗夫/
Abuc	/阿布奇/
Abucar	/阿布卡尔/
Abuchaibe	/阿武查伊韦/
Abucsay	/奥布乔伊/
Abuddin	/阿卜丁/
Abudeyev	/阿布杰耶夫/
Abudllah	/阿卜杜拉/
Abudo	/阿布多/
Abudul	/阿卜杜勒/
Abuduli	/阿卜杜利/
Abudullah	/阿卜杜拉/
Abuel	/阿布/
Abugoch	/阿武戈奇/
Abugov	/阿布戈夫/
Abuhan	/阿布汗/
Abuin	/阿武因/
Abuja	/阿布贾/阿武哈/
Abujeta	/阿武赫塔/
Abujetas	/阿武赫塔斯/
Abuk	/阿布克/
Abukawa	/虻川/
Abukhaidze	/阿布海泽/
Abukhayat	/阿布哈亚特/
Abukhov	/阿布霍夫/
Abukous	/阿布库斯/
Abukov	/阿布科夫/
Abukur	/阿布库尔/
Abul	/阿布/
Abul-Dzhabbar	/阿布－贾巴尔/
Abul-Feyz-khan	/阿布－法伊兹·汗/
Abul-Huda	/阿布－胡达/
Abul-Ula	/阿布－乌拉/
Abuladze	/阿布拉泽/
Abulafyev	/阿布拉菲耶夫/
Abulashvili	/阿布拉什维利/
Abulfaraj	/阿布－法拉杰/
Abulfaz	/阿布法兹/
Abulfazl	/阿布－法兹勒/
Abulfeda	/阿布－菲达/
Abulfeyz	/阿布法伊兹/
Abulfida	/阿布－菲达/
Abulgasan	/阿布哈桑/
Abulgasyan	/阿布哈桑/
Abulhasan	/阿布－哈桑/
Abulhaya	/阿布哈亚/
Abulius	/阿布柳什/
Abulker	/阿比尔克/
Abulkhanov	/阿布哈诺夫/
Abulkhayr	/阿布海尔/
Abulkheir	/阿布海尔/
Abullin	/阿布林/
Abulmanov	/阿布利马诺夫/
Abulmaoli	/阿布毛利/
Abulov	/阿布洛夫/
Abulu	/阿布卢/
Abulyak	/阿布利亚克/
Abulyanbagi	/阿布利扬巴吉/
Abumalhan	/阿武马利安/
Abumansur	/阿布曼苏尔/
Abumitani	/镫谷/
Abumiya	/镫屋/
Abumov	/阿布莫夫/
Abumussi	/阿布穆西/
Abun	/蛙文/
Abunachimov	/阿布纳奇莫夫/
Abunassar	/阿布－纳赛尔/
Abundancia	/阿文丹西亚/
Abundi	/阿本迪/
Abundio	/阿文迪奥/
Abundo	/阿本多/阿文多/
Abune	/阿布内/
Abunei	/阿布内伊/
Abunomatsu	/阿武松/
Abur	/阿布尔/
Aburaasa	/油浅/
Aburada	/油田/
Aburadani	/油谷/
Aburaden	/油田/
Aburagawa	/油川/
Aburagi	/油木/
Aburahara	/油原/
Aburahashi	/油桥/
Aburai	/油井/
Aburakami	/油上/
Aburakawa	/油川/
Aburakoji	/油小路/
Aburamoto	/油本/
Aburano	/油野/
Aburanokoji	/油小路/
Aburas	/阿布拉斯/
Aburata	/油田/
Aburatani	/油谷/
Aburatsu	/油津/
Aburaya	/油谷/油屋/
Aburayama	/油山/
Aburbe	/阿比尔贝/
Aburel	/阿布雷尔/
Aburizal	/阿布里扎尔/
Aburrazak	/阿布－拉扎克/
Aburto	/阿武尔托/
Aburuza	/阿武鲁萨/
Abus	/阿布什/
Abusaid	/阿布－赛义德/
Abusalik	/阿布萨利克/
Abusch	/阿布施/
Abuse	/阿比斯/
Abushayev	/阿布沙耶夫/
Abushenko	/阿布申科/
Abusinov	/阿布希诺夫/
Abuska	/阿布什卡/
Abusleme	/阿武斯莱梅/
Abusoglu	/阿布什奥卢/
Abussamah	/阿布－萨马赫/
Abussi	/阿布西/
Abut	/阿布特/
Abutalib	/阿布塔利布/
Abutalip	/阿布塔利普/
Abutidze	/阿布季泽/
Abutin	/阿布京/
Abutkova	/阿布特科娃/
Abutolinov	/阿布托利诺夫/
Abutori	/阿布托里/
Abutsu	/阿佛/
Abuyah	/阿布亚/
Abuyev	/阿布耶夫/
Abuz	/阿布兹/
Abuzarov	/阿布扎罗夫/
Abuzeid	/阿布－扎伊德/
Abuzer	/阿布泽尔/
Abuzin	/阿布津/
Abuzov	/阿布佐夫/
Abuzyarov	/阿布贾罗夫/
Abvelj	/阿布韦利/
Abwaisasa	/阿布瓦伊萨萨/
Aby	/阿比/
Abyad	/阿比阿德/
Abyadh	/阿比阿德/
Abyan	/阿比安/
Abybouka	/阿比布卡/
Abykaev	/阿贝卡耶夫/
Abykayev	/阿贝卡耶夫/
Abylkas	/阿贝尔卡斯/
Abylov	/阿贝洛夫/
Abyzbayev	/阿贝兹巴耶夫/
Abyzgildin	/阿贝兹吉利金/
Abyzov	/阿贝佐夫/
Abzac	/阿布扎克/
Abzaletdinov	/阿布扎列季诺夫/
Abzalon	/阿布扎隆/
Abzalov	/阿布扎洛夫/
Abzeyev	/阿布泽耶夫/
Abzhalilov	/阿布扎利洛夫/
Abzolkin	/阿布佐尔金/
Abzoltovska	/阿布若尔托夫斯卡/
Abzug	/阿布朱格/
Aca	/阿察/阿贾/阿卡/阿恰/
Acabarali	/阿卡巴拉利/
Acabay	/阿恰巴伊/
Acace	/阿卡切/
Acacia	/阿卡恰/
Acacio	/阿卡西奥/
Acadias	/阿卡迪亚斯/
Acadory	/阿卡多里/
Acaei	/阿卡埃/
Acaii	/阿凯伊/
Acainas	/阿卡伊尼亚斯/
Acak	/阿卡克/
Acal	/阿卡尔/
Acali	/阿卡利/
Acalinovic	/阿察利诺维奇/
Acalu	/阿卡吕/
Acam	/阿查姆/
Acamas	/阿卡马/
Acampa	/阿坎帕/
Acampora	/阿坎波拉/
Acan	/阿灿/
Acanal	/阿恰纳尔/
Acanfora	/阿坎福拉/
Acanski	/阿钱斯基/
Acanthe	/阿康特/
Acaoude	/阿卡欧德/
Acapulco	/阿卡普尔科/
Acar	/阿贾尔/阿卡尔/阿恰尔/
Acara	/阿贾拉/
Acaralp	/阿贾拉尔普/
Acarbay	/阿贾尔巴伊/
Acarbey	/阿贾尔贝伊/
Acard	/阿卡尔/
Acarel	/阿贾雷尔/
Acarer	/阿贾雷尔/
Acario	/阿卡里奥/
Acarkan	/阿贾尔坎/
Acarlar	/阿贾拉尔/
Acarli	/阿贾尔勒/阿恰尔勒/
Acarman	/阿贾尔曼/
Acaroglu	/阿贾尔奥卢/
Acaroz	/阿贾勒兹/
Acarq	/阿卡尔/
Acarsoy	/阿贾尔索伊/
Acarturk	/阿贾蒂尔克/
Acaru	/阿卡鲁/
Acaso	/阿卡索/
Acasuso	/阿卡苏索/
Acasysi	/阿卡西西/
Acat	/阿贾特/
Acatay	/阿贾塔伊/
Acatincai	/阿卡廷克伊/
Acatrinei	/阿卡特里内伊/
Acauto	/阿科托/
Acava	/阿卡瓦/
Acay	/阿贾伊/
Acca	/阿卡/
Accad	/阿卡/阿卡德/
Accadia	/阿卡迪亚/
Accalai	/阿卡拉伊/
Accambry	/阿康布里/
Accame	/阿卡梅/
Accaoui	/阿卡维/
Accaputo	/阿卡普托/
Accar	/阿卡尔/
Accaramboni	/阿卡兰博尼/
Accard	/阿卡尔/
Accardi	/阿卡尔迪/
Accardo	/阿卡尔多/
Accari	/阿卡里/
Accarias	/阿卡里亚斯/
Accarie	/阿卡里/
Accarier	/阿卡里耶/
Accarino	/阿卡里诺/
Accarisi	/阿卡里西/
Accarrino	/阿卡里诺/
Accart	/阿卡尔/
Accary	/阿卡里/
Accascina	/阿卡希纳/
Accascio	/阿卡肖/
Accastello	/阿卡斯泰洛/
Accati	/阿卡蒂/
Accatino	/阿卡蒂诺/
Accattatis	/阿卡塔蒂斯/
Accault	/阿科/
Accel	/阿塞尔/
Accerboni	/阿切尔博尼/
Accessoires	/阿塞苏瓦尔/
Accessor	/阿塞索尔/
Accetta	/阿切塔/阿塞塔/
Accettella	/阿切泰拉/
Accetti	/阿切蒂/
Accettola	/阿切托拉/
Accettone	/阿切托内/
Accettulli	/阿切图利/
Accettura	/阿切图拉/阿塞图拉/
Accetturi	/阿切图里/
Accetturo	/阿切图罗/
Accetulli	/阿切图利/
Acchia	/阿基亚/
Acchiardi	/阿基亚尔迪/
Acchiardo	/阿基亚尔多/
Acchione	/阿基奥内/
Acchioni	/阿基奥尼/
Acci	/阿奇/
Acciacatura	/阿恰卡图拉/
Acciacca	/阿恰卡/
Acciaccarelli	/阿恰卡雷利/
Acciai	/阿恰伊/
Acciaioli	/阿恰约利/
Acciani	/阿恰尼/
Acciaresi	/阿恰雷西/
Acciari	/阿恰里/
Acciariello	/阿恰列洛/
Acciarini	/阿恰里尼/
Acciarino	/阿恰里诺/
Acciarito	/阿恰里托/
Acciaro	/阿恰罗/
Acciaroli	/阿恰罗利/
Acciarri	/阿恰里/
Acciavatti	/阿恰瓦蒂/
Accica	/阿奇卡/
Accili	/阿奇利/
Accinelli	/阿奇内利/
Accinni	/阿钦尼/
Accinno	/阿钦诺/
Accio	/阿乔/
Accioli	/阿西奥利/
Accioly	/阿西奥利/
Accivile	/阿奇维莱/
Acclavio	/阿克拉维奥/
Acclestone	/阿克尔斯通/
Accoce	/阿科塞/
Accodo	/阿科多/
Accogli	/阿科利/
Accolas	/阿科拉/
Accolla	/阿科拉/
Accolli	/阿科利/
Accolti	/阿科尔蒂/
Accomando	/阿科曼多/
Accomasso	/阿科马索/
Accompagnato	/阿孔帕尼亚托/
Acconci	/阿孔奇/
Acconcia	/阿孔恰/
Acconciamessa	/阿孔恰梅萨/
Accoramboni	/阿科兰博尼/
Accordato	/阿科尔达托/
Accordi	/阿科尔迪/
Accordino	/阿科尔迪诺/
Accorinti	/阿科林蒂/
Accornero	/阿科尔内罗/
Accorona	/阿科罗纳/
Accoroni	/阿科罗尼/
Accorroni	/阿科罗尼/
Accorsi	/阿科尔西/
Accorsini	/阿科尔西尼/
Accorso	/阿科尔索/
Accos	/阿科/
Accossato	/阿科萨托/
Accosta	/阿科斯塔/
Accoto	/阿科托/
Accotto	/阿科托/
Accou	/阿库/
Accrocca	/阿克罗卡/
Accrogliano	/阿克罗利亚诺/
Accumoli	/阿库莫利/
Accursi	/阿库尔西/
Accurso	/阿库尔索/
Accurti	/阿库尔蒂/
Acdereli	/阿克代雷利/
Ace	/埃斯/
Acebal	/阿塞瓦尔/
Acebedo	/阿塞韦多/
Acebes	/阿塞韦斯/
Acebez	/阿塞韦斯/
Acebo	/阿塞沃/埃斯博/
Acebon	/阿塞翁/
Acebron	/阿塞夫龙/
Aced	/阿塞德/
Acedanski	/阿采丹斯基/
Acedera	/阿塞德拉/
Acedo	/阿塞多/
Acedos	/阿塞多斯/
Aceitero	/阿塞特罗/
Aceiton	/阿塞顿/
Aceitores	/阿塞托雷斯/
Aceituno	/阿塞图诺/
Aceizabarrena	/阿塞萨瓦雷纳/
Acel	/阿塞尔/奥采尔/
Acelenescu	/阿切莱内斯库/
Acelin	/阿瑟兰/
Aceline	/阿瑟利纳/
Acelinot	/阿瑟利诺/
Acella	/阿切拉/
Acemyan	/阿杰姆扬/
Acen	/阿森/
Acena	/阿塞尼亚/
Acenas	/阿塞尼亚斯/
Acenera	/阿塞涅拉/
Acenero	/阿塞涅罗/
Acenso	/阿森索/
Acer	/阿杰尔/阿瑟/
Acera	/阿塞拉/
Acerbi	/阿切尔比/阿塞尔维/
Acerbo	/阿切尔博/
Acerboni	/阿切尔博尼/阿塞沃尼/
Acereda	/阿塞雷达/
Acerenza	/阿切伦扎/
Aceres	/阿塞雷斯/
Acerete	/阿塞雷特/
Aceri	/阿切里/
Acerna	/阿切尔纳/
Acernese	/阿切尔内塞/
Acerni	/阿切尔尼/
Acerno	/阿切尔诺/
Acernus	/阿采尔努斯/
Acero	/阿切罗/阿塞罗/
Aceros	/阿塞罗斯/
Acerra	/阿切拉/
Aceski	/阿采斯基/
Acetelli	/阿切泰利/
Aceti	/阿切蒂/
Aceto	/阿切托/
Aceval	/阿塞瓦尔/
Acevedo	/阿塞韦多/
Aceves	/阿塞韦斯/
Acevez	/阿塞韦斯/
Acevic	/阿采维奇/阿切维奇/
Acevillo	/阿塞维略/
Acevo	/阿塞沃/
Acevski	/阿采夫斯基/
Acezat	/阿塞扎/
Acguani	/阿克瓜尼/
Ach	/阿/阿赫/
Acha	/阿查/阿沙/
Achaari	/阿沙里/
Achabal	/阿查瓦尔/
Achac	/阿哈奇/
Achach	/阿沙什/
Achache	/阿沙什/
Achacz	/奥恰茨/
Achad	/阿哈德/
Achada	/阿沙达/
Achadi	/阿哈迪/
Achaerandio	/阿查埃兰迪奥/
Achahabi	/阿谢哈比/
Achahbar	/阿沙巴尔/
Achain	/阿尚/
Achaintre	/阿尚特/
Achakazai	/阿查卡扎伊/
Achakzai	/阿查克扎伊/
Achalandabaso	/阿查兰达瓦索/
Achale	/阿沙莱/
Achalle	/阿沙勒/
Achalov	/阿恰洛夫/
Achamba	/阿昌巴/
Achando	/阿尚多/
Achap	/阿沙/
Achaques	/阿查克斯/
Achard	/阿查德/阿哈德/阿沙尔/
Achari	/阿沙里/
Acharius	/阿卡里乌斯/
Acharkan	/阿恰尔坎/
Acharri	/阿沙里/
Achart	/阿沙尔/
Achary	/阿沙里/
Acharya	/阿查里雅/
Acharyan	/阿恰良/
Achat	/阿沙/
Achates	/阿卡特斯/阿凯蒂斯/
Achatz	/阿卡兹/奥恰茨/
Achatzy	/阿哈齐/
Achau	/阿乔/
Achaume	/阿绍姆/
Achaval	/阿查瓦尔/
Achaz	/阿哈茨/
Achba	/阿奇巴/
Achberger	/阿赫贝格尔/
Achdiat	/阿赫迪亚特/
Achdjian	/阿什吉安/
Ache	/阿赫/阿切/阿谢/
Acheampong	/阿昌庞/
Achebe	/阿切贝/
Acheck	/阿谢克/
Achedikh	/阿谢迪赫/
Achefer	/阿什费/
Achefert	/阿什费尔/
Achega	/阿谢加/
Acheikh	/阿谢赫/
Achek	/阿谢克/
Achekian	/阿什基昂/
Achekzai	/阿切克扎伊/
Achel	/阿谢尔/奥切尔/
Achelaritei	/阿凯勒里采伊/
Achelino	/阿凯利诺/
Achelis	/阿赫利斯/阿基利斯/
Achemann	/阿谢曼/
Achenbach	/阿亨巴赫/阿肯巴克/
Achene	/阿凯内/
Achener	/阿什内/
Achenwall	/阿亨瓦尔/
Achenza	/阿肯扎/
Acher	/阿赫尔/阿克/阿谢/
Acheraoui	/阿谢拉维/
Acheray	/阿什雷/
Achereau	/阿什罗/
Acherkan	/阿切尔坎/
Acherman	/阿克曼/
Achermann	/阿克尔曼/
Achermanschi	/阿克曼斯基/
Acheroff	/阿切罗夫/阿什罗夫/
Acheron	/阿克龙/
Acherve	/阿谢尔韦/
Achery	/阿什里/
Acheson	/艾奇逊/
Achhab	/阿什哈卜/
Achhammer	/阿查默/阿克哈默/
Achhorner	/阿克霍纳/
Achi	/阿希/阿知/阿智/安/安致/
Achiaga	/阿恰加/
Achiary	/阿夏里/
Achiba	/阿知波/
Achich	/奥谢什/
Achichi	/奥谢什/
Achidi	/阿希迪/
Achie	/阿希/谒睿/
Achieng	/阿钦/
Achigi	/安敕城/
Achihaitei	/阿基赫伊采伊/
Achika	/安直/安敕/
Achikata	/味方/
Achiki	/阿直/阿直岐/安敕/安敕城/
Achikishi	/阿知吉师/
Achildiyev	/阿奇利季耶夫/
Achileas	/阿希莱亚斯/
Achilina	/阿基利娜/
Achillas	/阿希亚/
Achille	/阿奇列/阿希尔/阿希莱/
Achilles	/阿基莱斯/阿奇列斯/阿希莱斯/
Achilleus	/阿希莱夫斯/
Achilli	/阿基利/
Achillini	/阿基利尼/
Achim	/阿基姆/阿奇姆/阿希姆/
Achima	/味真/
Achimeier	/阿希迈尔/
Achimescu	/阿基梅斯库/
Achimo	/阿希莫/
Achin	/阿尚/
Achinami	/阿知波/
Achinger	/阿兴格尔/
Achingui	/阿欣吉/
Achinosuke	/阿智之助/
Achinstein	/阿钦斯坦/阿欣施泰因/
Achintya	/阿钦蒂亚/
Achio	/阿希奥/
Achir	/阿希尔/
Achirica	/阿奇里卡/
Achiriloaei	/阿基里洛阿埃伊/
Achis	/阿希斯/
Achitei	/阿基采伊/
Achiteni	/阿基采尼/
Achiti	/阿基齐/
Achivei	/阿基韦伊/
Achiwa	/阿知波/阿知和/
Achkanov	/阿奇卡诺夫/
Achkar	/阿奇卡尔/阿什卡尔/
Achkasov	/阿奇卡索夫/
Achkouti	/阿什库提/
Achleitner	/阿赫莱特纳/
Achmad	/艾哈迈德/
Achmadi	/艾哈迈迪/
Achmann	/阿什曼/
Achmar	/阿赫马尔/阿什马尔/
Achmatowicz	/阿赫马托维奇/
Achmawi	/阿什马维/
Achmed	/艾哈迈德/
Achmedowa	/阿赫梅多瓦/
Achmet	/艾哈迈德/
Achmizov	/阿奇米佐夫/
Achnamian	/阿克纳米昂/
Achnitz	/阿赫尼茨/
Achon	/阿雄/
Achondo	/阿琼多/
Achonry	/阿肯里/
Achor	/阿绍尔/埃科尔/
Achorn	/埃科恩/
Achotegui	/阿乔特吉/
Achou	/阿舒/
Achouah	/阿舒亚/
Achouba	/阿舒巴/
Achouch	/阿舒什/
Achouche	/阿舒什/
Achouel	/阿舒埃尔/
Achour	/阿舒尔/
Achrafieh	/阿什拉菲耶/
Achran	/阿奇兰/
Achray	/阿克雷/
Achremenko	/阿赫雷门科/
Achren	/阿克伦/
Achrerova	/阿赫雷罗娃/
Achs	/阿克斯/
Achsel	/阿克塞尔/
Achso	/阿奇索/
Achstetter	/阿赫施泰特/
Acht	/阿赫特/
Achta	/阿什塔/
Achten	/阿赫滕/
Achtenberg	/阿克滕伯格/
Achtenhagen	/阿赫滕哈根/
Achter	/阿赫特/
Achterberg	/阿赫特贝格/
Achternbusch	/阿赫特恩布施/
Achterrath	/阿赫特拉特/
Achtiany	/阿奇蒂亚尼/
Achtman	/阿克特曼/
Achtmann	/阿赫特曼/
Achtner	/阿赫特纳/埃希特纳/
Achtnich	/阿赫特尼希/
Achtznik	/阿赫茨尼克/
Achu	/阿舒/
Achucarro	/阿丘卡罗/
Achura	/阿丘拉/
Achurra	/阿丘拉/
Achury	/阿丘里/
Achutanandan	/阿楚塔南丹/
Achutegui	/阿丘特吉/
Achutha	/阿楚塔/
Achuzia	/阿丘齐亚/
Achyut	/阿奇尤特/
Aci	/阿奇/
Acibase	/阿奇巴塞/
Acic	/阿契奇/阿西克/
Acichian	/阿奇基安/
Acicoya	/阿西科亚/
Acidaro	/阿奇达罗/
Acidi	/阿奇迪/
Acidini	/阿奇迪尼/
Aciduman	/阿哲杜曼/
Aciego	/阿谢戈/
Acien	/阿先/
Acier	/阿西耶/
Acieral	/阿西耶拉尔/
Acierex	/阿西耶雷/
Acieries	/阿西耶里/
Acierno	/阿切尔诺/
Acieroid	/阿西耶鲁瓦/
Aciers	/阿西耶尔/
Aciganovic	/阿齐加诺维奇/
Acik	/阿彻克/阿奇克/
Acika	/阿齐卡/
Acikalin	/阿彻卡伦/
Acikbas	/阿彻克巴什/
Acikel	/阿彻凯尔/
Acikgoz	/阿彻克格兹/
Acikgul	/阿彻克居尔/
Acikgun	/阿彻克金/
Aciksoz	/阿彻克瑟兹/
Aciksozlu	/阿彻克瑟兹吕/
Acil	/阿彻尔/
Acilon	/阿西隆/
Acilu	/阿西卢/
Acim	/阿契姆/
Acima	/阿契玛/
Aciman	/阿西曼/阿哲曼/
Acimic	/阿契米奇/
Acimov	/阿契莫夫/
Acimovac	/阿契莫瓦茨/
Acimovic	/阿契莫维奇/
Acin	/阿钦/阿辛/
Acina	/阿西纳/
Acinas	/阿西纳斯/
Aciobanitei	/阿乔伯尼采伊/
Aciocoitei	/阿乔科伊采伊/
Acioglu	/阿哲奥卢/
Acioli	/阿西奥利/
Acipayamli	/阿哲帕亚姆勒/
Acir	/阿西尔/阿哲尔/
Aciron	/阿西龙/
Acis	/阿西/
Acisa	/阿西萨/
Acisclo	/阿西斯克洛/
Acislo	/阿西斯洛/
Acisti	/阿彻什特/
Acitelli	/阿奇泰利/
Acito	/阿奇托/
Acitores	/阿西托雷斯/
Aciu	/阿丘/
Aciubotaritei	/阿丘博特里采伊/
Acja	/阿查/阿恰/
Acjam	/阿查姆/
Acjim	/阿契姆/
Acjima	/阿契玛/
Acjko	/阿奇科/
Acjo	/阿乔/
Ackah	/阿卡/
Ackaouy	/阿卡维/
Acke	/阿茨凯/
Ackeberg	/阿克贝里/
Ackefelt	/阿克费尔特/
Ackefors	/阿克福什/
Ackein	/阿坎/
Ackell	/阿克尔/
Ackelman	/阿克尔曼/
Ackelmire	/阿克尔迈尔/
Ackelpohler	/阿克尔珀勒/
Ackels	/阿凯尔/
Ackemark	/阿克马克/
Acken	/阿肯/
Ackenheil	/阿肯海尔/
Ackenhoff	/阿肯霍夫/
Ackenine	/阿克尼纳/
Acker	/阿克/
Ackerberg	/阿克贝里/
Ackered	/阿克雷德/
Ackeren	/阿克伦/
Ackerfeldt	/阿克费尔特/
Ackerheim	/阿克海姆/
Ackerknecht	/阿克尔克内希特/
Ackerle	/埃克勒/
Ackerly	/阿克利/
Ackerman	/阿克曼/
Ackermann	/阿克曼/
Ackermark	/阿克马克/
Ackermeier	/阿克迈尔/
Ackern	/阿克恩/
Ackers	/阿克斯/
Ackerschott	/阿克朔特/
Ackerson	/阿克森/
Ackerstedt	/阿克施泰特/阿克斯泰特/
Ackerstrand	/阿克斯特兰德/
Ackert	/阿克特/
Ackerup	/阿克吕普/
Ackeryd	/阿克吕德/
Acketa	/阿茨凯塔/
Ackheden	/阿克赫登/
Ackim	/阿基姆/
Ackingul	/阿奇肯居尔/
Ackland	/阿克兰/
Acklau	/阿克劳/
Acklen	/阿克伦/
Ackley	/阿克利/
Acklin	/阿克林/
Ackmark	/阿克马克/
Ackner	/阿克纳/
Acko	/阿茨科/阿奇科/
Ackovic	/阿茨科维奇/
Ackovski	/阿茨科夫斯基/阿奇科夫斯基/
Ackren	/阿克伦/
Ackroyd	/阿克罗伊德/
Acksjo	/阿克舍/
Ackson	/阿克森/
Ackstein	/阿克斯坦/
Ackthen	/阿克滕/
Ackun	/阿奇昆/
Ackurt	/阿奇库尔特/
Ackzell	/阿克塞尔/
Acla	/阿克拉/
Acland	/阿克兰/
Acle	/阿克莱/
Aclocque	/阿克洛克/
Acloque	/阿克洛克/
Aclred	/阿克尔雷德/
Acly	/阿克利/
Acmazale	/阿奇马扎莱/
Aco	/阿措/阿乔/阿索/
Acobas	/阿科巴/
Acoca	/阿科卡/
Acocella	/阿科切拉/
Acofer	/阿索费尔/
Acojocaritei	/阿科若克里采伊/
Acolas	/阿科拉/
Acolet	/阿科莱/
Acollas	/阿科拉/
Acomanni	/阿科曼尼/
Acomb	/埃克姆/
Acome	/阿科姆/
Acon	/阿孔/
Acond	/阿孔德/
Acone	/阿科内/
Aconin	/阿科南/
Aconstantinesei	/阿康斯坦丁内塞伊/
Acorda	/阿索尔达/
Acorel	/阿科雷尔/
Acori	/阿科里/
Acoro	/阿科罗/
Acorsi	/阿科尔西/
Acosta	/阿科斯塔/
Acostachioae	/阿科斯塔基瓦耶/
Acostachioaiei	/阿科斯特基瓦耶伊/
Acostoaei	/阿科斯托阿埃伊/
Acott	/埃科特/
Acoulon	/阿库隆/
Acouri	/阿库里/
Acourt	/埃科特/
Acousti	/阿库斯蒂/
Acoustic	/阿库斯蒂克/
Acoustique	/阿库斯蒂克/
Acouvox	/阿库沃/
Acovic	/阿佐维奇/
Acovski	/阿佐夫斯基/
Acqua	/阿夸/
Acquaah	/阿库瓦/
Acquaderni	/阿夸代尔尼/
Acquadro	/阿夸德罗/
Acquafredda	/阿夸弗雷达/
Acquafresca	/阿夸弗雷斯卡/
Acquah	/阿库瓦/
Acqualagna	/阿夸拉尼亚/
Acquapendente	/阿夸彭登特/
Acquard	/阿卡尔/
Acquardi	/阿夸尔迪/
Acquarelli	/阿夸雷利/
Acquaro	/阿夸罗/
Acquaroli	/阿夸罗利/
Acquarone	/阿夸罗内/
Acquaroni	/阿夸罗尼/
Acquarossa	/阿夸罗萨/
Acquart	/阿卡尔/
Acquasanta	/阿夸桑塔/
Acquati	/阿夸蒂/
Acquaviva	/阿夸维瓦/
Acquaye	/阿夸耶/
Acquette	/阿凯特/
Acqui	/阿奎/
Acquie	/阿基耶/
Acquier	/阿基耶/
Acquilino	/阿奎利诺/
Acquista	/阿奎斯塔/
Acquistapace	/阿奎斯塔帕切/
Acquisti	/阿奎斯蒂/
Acquisto	/阿奎斯托/
Acquistucci	/阿奎斯图奇/
Acquitter	/阿基泰/
Acra	/阿克拉/
Acral	/阿克拉尔/
Acree	/阿克雷/阿克里/
Acrelius	/阿克雷利乌斯/
Acreman	/阿克雷曼/
Acremant	/阿克勒芒/
Acremont	/阿克勒蒙/
Acres	/阿克尔/
Acret	/阿克雷特/
Acretoaei	/阿克雷托阿埃伊/
Acri	/阿克里/
Acriala	/阿克里亚勒/
Acrich	/阿克里奇/
Acriche	/阿克里什/
Acriman	/阿克里曼/
Acriter	/阿克里泰/
Acriz	/阿克里斯/
Acroca	/阿克罗卡/
Acropole	/阿克罗波勒/
Acrosso	/阿克罗索/
Acs	/阿克斯/阿奇/
Acsadi	/奥恰迪/
Acsady	/奥恰迪/
Acsai	/奥乔伊/
Acsay	/奥乔伊/
Acsente	/阿克森特/
Acsenti	/阿克森蒂/
Acsiniei	/阿克西涅伊/
Acsinte	/阿克辛特/
Acsinteanu	/阿克辛泰亚努/
Acsintovici	/阿克辛托维奇/
Acsman	/阿奇曼/
Acta	/阿克塔/
Actarian	/阿克塔里安/
Acterfeld	/阿克特费尔德/
Acti	/阿克蒂/
Actif	/阿克蒂夫/
Actino	/阿克蒂诺/
Actis	/阿克蒂/阿克蒂斯/
Activente	/阿克蒂旺特/
Actiz	/阿克蒂斯/
Acto	/阿克托/
Acton	/阿克东/阿克顿/
Actorie	/阿克托里/
Acuarez	/阿夸雷斯/
Acuario	/阿夸里奥/
Acucena	/阿苏塞纳/
Aculai	/阿库拉伊/
Aculina	/阿库利娜/
Aculov	/阿库洛夫/
Acun	/阿均/
Acuna	/阿库纳/阿库尼亚/
Acunal	/阿久纳尔/
Acunalan	/阿久纳兰/
Acunalp	/阿久纳尔普/
Acunas	/阿久纳斯/
Acunbali	/阿均巴勒/
Acuner	/阿久内尔/
Acunman	/阿均曼/
Acunseven	/阿均塞文/
Acunsever	/阿均塞韦尔/
Acunzo	/阿昆佐/
Acurcio	/阿库尔西奥/
Acurio	/阿库里奥/
Acustica	/阿库斯蒂卡/
Acuti	/阿库蒂/
Acutis	/阿库蒂斯/
Acuto	/阿库托/
Acuviso	/阿库维索/
Acuvisos	/阿库维索斯/
Acuyo	/阿库约/
Acworth	/阿克沃思/
Acyl	/阿西尔/
Acyr	/阿西尔/
Aczberger	/阿茨贝格尔/
Aczel	/阿克塞尔/奥采尔/
Aczelhoffer	/阿策尔霍费尔/
Ad	/阿德/
Ada	/阿达/阿太/阿陀/埃达/奥道/足代/
Adabachi	/阿达巴希/
Adace	/阿达切/
Adache	/阿卡什/
Adacher	/阿达凯尔/
Adachi	/阿达/阿立/安达/安建/安立/足立/
Adachibara	/足立原/
Adachihara	/足立原/
Adad	/阿达/
Adada	/阿达达/
Adade	/阿达德/
Adadic	/阿达迪奇/
Adadurov	/阿达杜罗夫/
Adaes	/阿当伊斯/
Adagi	/安宅/
Adagio	/阿达焦/
Adah	/阿达赫/埃达/
Adahl	/奥达尔/
Adahyl	/阿达伊尔/
Adai	/阿代/奥道伊/
Adail	/阿代尔/
Adailton	/阿代尔顿/
Adaimy	/阿代米/
Adaine	/阿达因/
Adair	/阿达伊尔/阿代尔/
Adaixo	/阿代舒/
Adaj	/阿达伊/
Adak	/阿达克/
Adaka	/安宅/
Adakai	/阿陀加井/出云乡/
Adaker	/阿多克/
Adaki	/安宅/
Adakli	/阿达克勒/
Adal	/阿达尔/阿达勒/
Adala	/阿达拉/
Adalan	/阿达兰/
Adalbert	/阿达尔贝特/阿达尔韦特/阿德尔伯特/
Adalberti	/阿达尔贝蒂/
Adalbertman	/阿达尔贝特曼/
Adalbertmanova	/阿达尔贝特曼诺娃/
Adalberto	/阿达尔贝托/阿达尔韦托/
Adalet	/阿达莱特/
Adalgisa	/阿达尔吉萨/
Adalgiso	/阿达尔吉索/
Adali	/阿达勒/达利/
Adalia	/阿达利亚/
Adalicio	/阿达利西奥/
Adalid	/阿达利德/
Adalinska	/阿达林斯卡/
Adalio	/阿达略/
Adalioglu	/阿达勒奥卢/
Adaliz	/阿达利斯/
Adalstein	/阿达尔施泰因/
Adalsteinsson	/阿达尔斯泰因松/
Adalzira	/阿达尔齐拉/
Adam	/阿达姆/亚当/
Adama	/阿达玛/阿达马/
Adamache	/阿达马凯/
Adamachi	/阿达马基/
Adamafio	/阿达马菲奥/
Adamaly	/阿德马利/
Adamandides	/阿达芒迪德/
Adamanti	/阿达曼蒂/
Adamantios	/阿扎曼蒂奥斯/
Adamaoua	/阿达马瓦/
Adamar	/阿达马尔/
Adamastor	/阿达马斯托/
Adamat	/奥道马特/
Adamberger	/亚当贝格尔/
Adamcak	/亚当恰克/
Adamchuk	/阿达姆丘克/
Adamcik	/亚当奇克/
Adamcikova	/亚当奇科娃/
Adamcova	/亚当佐娃/
Adamcsa	/奥道姆乔/
Adamcsak	/奥道姆恰克/
Adamcsik	/奥道姆奇克/
Adamcso	/奥道姆乔/
Adamcsok	/奥道姆乔克/
Adamczak	/亚当恰克/
Adamczewska	/亚当切夫斯卡/
Adamczewski	/亚当切夫斯基/
Adamczyk	/亚当奇克/
Adamczykova	/亚当奇科娃/
Adame	/阿达梅/奥道迈/
Adamec	/阿达麦茨/阿达梅茨/奥道迈茨/
Adameck	/阿达梅克/
Adamecz	/奥道迈茨/
Adamek	/阿达梅克/奥道迈克/司达梅克/
Adamello	/阿达梅洛/
Adamenko	/阿达缅科/
Adamenti	/阿达门蒂/
Adamer	/阿达梅尔/
Adames	/阿达梅斯/
Adamescu	/阿达梅斯库/
Adamesteanu	/阿达梅斯泰亚努/
Adamet	/阿达梅特/
Adamets	/阿达梅茨/
Adametz	/奥道迈茨/
Adamffy	/奥达姆菲/
Adamfi	/奥达姆菲/
Adamfia	/奥达姆菲奥/
Adamgaliyev	/阿达姆加利耶夫/
Adami	/阿达米/奥达米/
Adamian	/阿达米安/阿达米昂/阿达米扬/
Adamic	/阿达米克/阿达米奇/
Adamicka	/阿达米奇卡/
Adamickova	/阿达米奇科娃/
Adamide	/阿达米德/
Adamides	/阿达米季斯/
Adamiec	/阿达麦茨/
Adamiecki	/阿达梅茨基/
Adamietz	/阿达米茨/
Adamik	/阿达米克/奥道米克/
Adamina	/阿达米娜/
Adamini	/阿达米尼/
Adamira	/阿达米拉/
Adamirova	/阿达米罗娃/
Adamis	/奥道米什/
Adamishin	/阿达米申/
Adamiu	/阿达米乌/
Adamiuk	/阿达缪克/
Adamjee	/阿达姆吉/
Adamka	/亚当卡/亚当考/
Adamkiewicz	/亚当凯维奇/
Adamko	/亚当科/
Adamkova	/亚当科娃/
Adamkovich	/阿达姆科维奇/
Adamkus	/阿达姆库斯/
Adamnan	/阿达姆南/
Adamo	/阿达莫/
Adamoiu	/阿达莫尤/
Adamoli	/阿达莫利/
Adamonene	/阿达莫涅涅/
Adamonti	/阿达蒙蒂/
Adamopol	/阿达莫波尔/
Adamopoulos	/阿扎莫普洛斯/
Adamopulu	/阿扎莫普卢/
Adamos	/阿达莫斯/
Adamossi	/阿达莫希/
Adamou	/阿达穆/
Adamov	/阿达莫夫/
Adamova	/阿达莫娃/
Adamovic	/阿达莫维奇/
Adamovich	/阿达莫维奇/
Adamovici	/阿达莫维奇/
Adamovics	/阿达莫维奇/
Adamovits	/阿达莫维奇/
Adamovska	/阿达莫夫斯卡/
Adamovskaia	/阿达莫夫斯卡娅/
Adamovski	/阿达莫夫斯基/
Adamovsky	/阿达莫夫斯基/
Adamowski	/阿达莫夫斯基/
Adamowsky	/阿达莫夫斯基/
Adams	/亚当斯/
Adamsbaum	/亚当斯鲍姆/
Adamsen	/亚当森/
Adamski	/阿达姆斯基/亚当斯基/
Adamsky	/阿达姆斯基/亚当斯基/
Adamson	/亚当森/亚当松/
Adamsson	/亚当松/
Adamstone	/亚当斯通/
Adamthwaite	/亚当思韦特/
Adamtsik	/奥道姆齐克/
Adamu	/阿达穆/
Adamus	/阿达穆斯/
Adamut	/阿德穆特/
Adamuz	/阿达穆斯/
Adamy	/阿达米/奥达米/奥道米/
Adamyan	/阿达米扬/
Adamyuk	/阿达缪克/
Adamzyk	/阿达姆齐克/
Adan	/阿丹/
Adana	/阿达纳/
Adanalic	/阿达纳利奇/
Adanaz	/阿达纳斯/
Adancourt	/阿当古/
Adande	/阿丹德/
Adanero	/阿达内罗/
Adaneso	/阿达内索/
Adanet	/阿达内/
Adanetch	/阿达内奇/
Adanez	/阿达内斯/
Adang	/阿当/
Adani	/阿达尼/
Adania	/阿达尼亚/
Adaniloe	/阿达尼洛耶/
Adanin	/阿达宁/
Adanir	/阿达纳尔/
Adanishen	/阿达尼申/
Adanja	/阿达尼亚/
Adanjes	/阿丹热斯/
Adank	/阿丹克/
Adanlin	/阿丹林/
Adanovic	/阿达诺维奇/
Adanski	/阿丹斯基/
Adanson	/阿当松/
Adant	/阿当/
Adanti	/阿丹蒂/
Adanto	/阿丹托/
Adanur	/阿达努尔/
Adany	/奥达尼/
Adanya	/阿达尼亚/
Adanyi	/奥达尼/
Adao	/亚当/
Adaoglu	/阿达奥卢/
Adaoutema	/阿达乌泰马/
Adapazari	/阿达帕扎勒/
Adar	/阿达尔/
Adarbe	/阿达韦/
Adarchev	/阿达尔切夫/
Adare	/阿代尔/
Adaridi	/阿达里迪/
Adarkan	/阿达尔坎/
Adaro	/阿达罗/
Adarraga	/阿达拉加/
Adarve	/阿达韦/
Adarvez	/阿达韦斯/
Adaryukov	/阿达留科夫/
Adas	/阿达什/阿达斯/
Adasal	/阿达萨尔/
Adasani	/阿达萨尼/
Adascalitei	/阿德斯克利采伊/
Adasek	/阿达谢克/
Adasevic	/阿达舍维奇/
Adashchik	/阿达希克/
Adashev	/阿达舍夫/
Adashivski	/阿达希夫斯基/
Adashivsky	/阿达希夫斯基/
Adashkevich	/阿达什克维奇/
Adaskin	/阿达斯金/
Adasko	/阿达西科/
Adaskova	/阿达什科娃/
Adasovski	/阿达索夫斯基/
Adasovsky	/阿达索夫斯基/
Adass	/阿达斯/
Adassa	/阿达萨/
Adassani	/阿达萨尼/
Adatas	/阿达塔什/
Adatepe	/阿达泰佩/
Adato	/阿达托/防夫/防人/
Adatte	/阿达特/
Adatto	/阿达托/
Adaucto	/阿道克托/
Adauto	/阿道托/
Adawani	/阿达瓦尼/
Adawe	/阿达维/
Adawi	/阿达维/
Aday	/阿达伊/
Adayev	/阿达耶夫/
Adayilmaz	/阿达耶尔马兹/
Adban	/阿德班/
Adbar	/阿德巴尔/
Adbring	/阿德布林/
Adcock	/阿德科克/
Adda	/阿达/
Addabbo	/阿达博/
Addad	/阿达/阿达德/
Addada	/阿达达/
Addadi	/阿达迪/
Addae	/阿达/
Addali	/阿达利/
Addam	/阿扎姆/
Addamiani	/阿达米亚尼/
Addamiano	/阿达米亚诺/
Addamo	/阿达莫/
Addams	/亚当斯/
Addante	/阿丹特/
Addari	/阿达里/
Addati	/阿达蒂/
Addazi	/阿达齐/
Adde	/阿代/阿德/
Addei	/阿代伊/
Addeke	/阿德克/
Adden	/阿登/
Addendum	/阿登杜姆/
Addeo	/阿代奥/
Adderley	/阿德利/
Addesse	/阿代塞/
Addessi	/阿代西/
Addesso	/阿代索/
Addestri	/阿代斯特里/
Addi	/阿迪/
Addicks	/阿迪克斯/
Addin	/阿丁/
Adding	/阿丁/
Addington	/阿丁顿/
Addino	/阿迪诺/
Addinsell	/阿丁塞尔/
Addis	/阿迪斯/亚的斯/
Addison	/阿迪松/艾迪生/
Additon	/阿迪顿/
Addivinola	/阿迪维诺拉/
Addleshaw	/阿德尔肖/
Addo	/阿多/
Addobbati	/阿多巴蒂/
Addografica	/阿多格拉菲卡/
Addoh	/阿杜/
Addonisio	/阿多尼西奥/
Addonizio	/阿多尼齐奥/阿多尼西奥/
Addor	/阿多尔/
Addosh	/杜什/
Addosio	/阿多西奥/
Addou	/阿杜/
Addoud	/阿杜德/
Addow	/阿道/
Adduard	/阿杜亚尔德/
Adduca	/阿杜卡/
Adducchio	/阿杜基奥/
Adducci	/阿杜奇/
Adduci	/阿杜奇/
Addums	/阿达姆斯/
Adduqail	/杜凯勒/
Addy	/阿迪/
Ade	/阿德/埃德/安谛/
Adea	/阿德亚/
Adeane	/阿迪恩/
Adeang	/阿德昂/
Adeans	/阿代昂/
Adeau	/阿多/
Adeb	/阿德卜/
Adeba	/阿德瓦/
Adeback	/阿德贝克/
Adebahr	/阿德巴尔/
Adebayo	/阿德巴约/
Adeberg	/阿德贝里/
Adebisi	/阿德比西/
Adebo	/阿德博/
Adebola	/阿德博拉/
Adebrand	/阿德布兰德/
Adebring	/阿德布林/
Adebrink	/阿德布林克/
Adebro	/阿德布罗/
Adebumi	/阿德布米/
Adeby	/阿德比/
Adecoroye	/阿德科罗耶/
Adecta	/阿代克塔/
Aded	/阿代德/
Adede	/阿德德/
Adedeji	/阿德德吉/
Adediran	/阿德迪兰/
Adedoja	/阿德多贾/
Adedori	/阿代多里/
Adedun	/阿德敦/
Adee	/埃迪/
Adeeb	/阿迪卜/
Adeed	/阿迪德/
Adeel	/阿迪勒/
Adeen	/阿登/
Adefope	/阿德福佩/
Adega	/阿德加/
Adegaha	/阿德加阿/
Adegard	/阿德加德/
Adegas	/阿德加斯/
Adegawa	/阿出川/
Adegbenro	/阿德本罗/
Adegboro	/阿德博罗/
Adegbuyi	/阿德布伊/
Adegoroye	/阿德戈罗耶/
Adegren	/阿德格伦/
Adeguero	/阿德格罗/
Adehed	/阿德赫德/
Adeil	/阿代勒/
Adeishvili	/阿德伊什维利/
Adeito	/阿代托/
Adejuwon	/阿代朱翁/
Adekawa	/阿出川/
Adekoroye	/阿德科罗耶/
Adekpedjou	/阿代佩朱/
Adekunle	/阿德昆莱/
Adekuoye	/阿德阔耶/
Adel	/阿德尔/
Adela	/阿德拉/
Adelaer	/阿德莱/
Adelaida	/阿德拉伊达/阿德莱达/阿杰莱达/
Adelaide	/阿代拉伊德/阿德莱德/
Adelaine	/阿德莱纳/
Adelaja	/阿德拉贾/
Adelantado	/阿德兰塔多/
Adelanwa	/阿德兰瓦/
Adelard	/阿代拉尔/
Adelardo	/阿德拉多/
Adelarpe	/阿德拉佩/
Adelarte	/阿德拉特/
Adelberg	/阿德尔贝格/
Adelberger	/阿德尔贝格尔/
Adelbert	/阿德尔贝特/阿德尔伯特/阿德尔韦特/
Adelbertsson	/阿德尔贝特松/
Adelbo	/阿德尔博/
Adelborg	/阿德尔堡/
Adelby	/阿德尔比/
Adelchi	/阿代尔基/
Adele	/阿代莱/阿代勒/阿德莱/阿德勒/阿黛尔/
Adeleke	/阿德莱克/
Adeler	/阿德勒尔/
Adelet	/阿德莱/
Adeleye	/阿德莱耶/
Adelfang	/阿代尔方/
Adelfi	/阿杰利菲/
Adelfii	/阿杰利菲/
Adelfina	/阿杰利芬娜/
Adelfio	/阿代尔菲奥/
Adelgard	/阿德尔高/
Adelgren	/阿德尔格伦/
Adelhag	/阿德尔哈格/
Adelheid	/阿德尔海德/
Adeli	/阿德利/
Adelia	/阿德利亚/奥代利亚/
Adelin	/阿德兰/
Adelina	/阿代利纳/阿德利娜/阿德林娜/
Adelind	/阿德林德/
Adeline	/阿德利纳/阿德琳/
Adelini	/阿代利尼/
Adelino	/阿德利诺/
Adelio	/阿德利奥/
Adelizzi	/阿代利齐/
Adell	/阿德尔/阿德利/
Adella	/阿代拉/
Adelle	/阿德尔/
Adelli	/阿代利/
Adelman	/阿德尔曼/
Adelmand	/阿代尔芒/
Adelmann	/阿德尔曼/
Adelmannsfeld	/阿德尔曼斯费尔德/
Adelmannsfelden	/阿德尔曼斯费尔登/
Adelmant	/阿代尔芒/
Adelmar	/阿德尔马/
Adelmo	/阿代尔莫/阿德尔莫/
Adelmuller	/阿德尔米勒/
Adelo	/阿德洛/
Adelow	/阿德勒夫/
Adelrot	/阿德尔罗特/
Adels	/阿德尔斯/
Adelsbach	/阿德尔斯巴赫/
Adelsjo	/阿德尔舍/
Adelskogh	/阿德尔斯科格/
Adelskold	/阿德尔舍尔德/
Adelsohn	/阿德尔松/
Adelstam	/阿德尔斯坦/
Adelsteen	/阿德尔斯滕/
Adelstein	/阿德尔施泰因/
Adelsten	/阿德尔斯滕/
Adelstrand	/阿德尔斯特兰德/
Adelstrom	/阿德尔斯特伦/
Adelsund	/阿德尔松德/
Adelsward	/阿德尔斯韦德/
Adelt	/阿德尔特/
Adeltova	/阿德尔托娃/
Adelung	/阿德隆/阿杰隆/
Adelungaden	/阿德隆加登/
Adelus	/阿德吕/
Adelusi	/阿代卢西/
Adeluysi	/阿代卢伊/
Adem	/阿当/阿德姆/
Adema	/阿德马/
Ademaj	/阿代马伊/
Ademar	/阿德马尔/
Ademe	/阿德梅/
Ademhan	/阿德姆汗/
Ademi	/阿代米/阿杰米/
Ademian	/阿德米昂/
Ademmer	/阿德默/
Ademoglu	/阿德姆奥卢/
Ademola	/阿德莫拉/
Ademollo	/阿代莫洛/
Ademovic	/阿代莫维奇/
Ademovski	/阿代莫夫斯基/
Ademyr	/阿德米尔/
Aden	/阿当/阿登/亚丁/
Adenacker	/阿德纳克/
Adenaeuer	/阿德诺伊尔/
Adenan	/阿德南/
Adenar	/阿德纳尔/
Adenau	/阿德瑙/
Adenauer	/阿德诺伊尔/阿登纳/
Adenback	/阿登贝克/
Adenberg	/阿登贝里/
Adenbrandt	/阿登布兰特/
Adenby	/阿登比/
Adenero	/阿德内罗/
Adenet	/阿德内/
Adeney	/阿德尼/
Adenez	/阿德内斯/
Adenfelt	/阿登费尔特/
Adeniji	/阿德尼吉/
Adenike	/阿德尼凯/
Adeniken	/阿德尼肯/
Adeniran	/阿德尼兰/
Adenis	/阿德尼/
Adenius	/阿德纽斯/
Adeniyi	/阿德尼伊/
Adenor	/阿德诺尔/
Adenot	/阿德诺/
Adensam	/阿登萨姆/
Adensjo	/阿登舍/
Adenskog	/阿登斯科格/
Adenstam	/阿登斯坦/
Adenstedt	/阿登斯泰特/
Adenvall	/阿登瓦尔/
Adenwalla	/阿登瓦拉/
Adeo	/阿德奥/
Adeodato	/阿德奥达托/
Adeogun	/阿德奥贡/
Adeola	/阿德奥拉/
Ader	/阿代尔/阿德/
Aderaks	/阿杰拉克斯/
Aderaldo	/阿德拉尔多/
Aderbauer	/阿德鲍尔/
Aderbo	/阿德博/
Aderca	/阿代卡/
Aderemi	/阿德雷米/
Aderfelt	/阿德费尔特/
Aderfors	/阿德福什/
Aderghal	/阿代加尔/
Aderheim	/阿德海姆/
Aderhold	/阿德霍尔德/
Aderinokun	/阿德里诺昆/
Aderito	/阿德里托/
Aderkas	/阿德卡斯/
Aderkin	/阿杰尔金/
Adermah	/阿代尔马赫/
Aderman	/阿德曼/
Adermark	/阿德尔马克/
Adermatt	/阿代马特/
Aderneira	/阿德内拉/
Aderno	/阿代尔诺/
Adero	/阿德勒/
Aderud	/阿德鲁德/
Adervall	/阿德瓦尔/
Ades	/阿代斯/阿德斯/埃兹/
Adesakin	/阿德萨金/
Adescenco	/阿代斯琴科/
Adesina	/阿德西纳/
Adesko	/阿德斯科/
Adesoi	/阿德索伊/
Adespei	/阿代斯佩伊/
Adesso	/阿代索/
Adestam	/阿德斯坦/
Adestedt	/阿德斯泰特/
Adet	/阿代/
Adetokunbo	/阿德托昆博/
Adetoro	/阿德托罗/
Adette	/阿德特/
Adetunji	/阿德通吉/
Adetutu	/阿德图图/
Adeuga	/阿德乌加/
Adeux	/阿德/
Adeva	/阿德瓦/
Adevinka	/阿德文卡/
Adevoso	/阿德沃索/
Adewale	/阿德瓦莱/
Adewoye	/阿德沃耶/
Adey	/阿代/阿迪/
Adeyemi	/阿德耶米/
Adeyeye	/阿德耶耶/
Adeyfield	/埃迪菲尔德/
Adfeldt	/阿德费尔特/
Adgam	/阿德加姆/
Adgamovich	/阿德加莫维奇/
Adger	/阿杰/
Adgert	/阿德格特/
Adhal	/阿达勒/
Adham	/阿扎姆/
Adhama	/阿扎马/
Adhami	/阿扎米/
Adhamy	/阿达米/
Adhdi	/阿兹迪/
Adhe	/阿德/
Adhemar	/阿代马尔/阿德马尔/
Adher	/阿代/
Adhera	/阿德拉/
Adherbal	/阿德巴尔/
Adhermar	/阿德马尔/
Adhidarmo	/阿迪达莫/
Adhikari	/阿迪卡里/
Adhikary	/阿迪卡里/
Adhin	/阿德欣/阿丁/
Adhira	/阿迪拉/
Adholm	/阿德霍尔姆/
Adhumeau	/阿迪莫/
Adhund	/阿敦德/
Adhyali	/阿贾利/
Adhyatman	/阿迪亚特曼/
Adi	/阿迪/安迪/
Adia	/阿迪亚/
Adiage	/阿迪亚热/
Adiahenot	/阿迪亚海诺特/
Adib	/阿迪卜/阿迪布/
Adiba	/阿迪巴/
Adibek	/阿季别克/
Adibelli	/阿德贝尔利/
Adibo	/阿迪博/
Adic	/阿迪奇/
Adichareh	/阿迪查雷/
Adick	/阿迪克/
Adicoff	/阿迪科夫/
Adida	/阿迪达/
Adie	/阿迪/
Adiego	/阿迭戈/
Adiele	/阿迪埃莱/
Adiels	/阿迪尔斯/
Adigard	/阿迪加尔/
Adigaw	/阿迪高/
Adige	/阿迪盖/阿迪热/
Adigesalov	/阿季格萨洛夫/
Adigezal	/阿季格扎尔/
Adigezalov	/阿季格扎洛夫/
Adigio	/阿迪希奥/
Adigton	/阿迪格顿/
Adiguine	/阿迪吉内/
Adigun	/阿德金/阿迪贡/
Adiguzel	/阿德居泽尔/
Adijes	/阿迪热/
Adikari	/阿迪卡里/
Adikayevski	/阿季卡耶夫斯基/
Adikayevsky	/阿季卡耶夫斯基/
Adikes	/阿代克斯/
Adiki	/阿季基/
Adikii	/阿季基/
Adil	/阿迪尔/阿迪勒/阿季尔/
Adila	/阿迪拉/
Adilardi	/阿迪拉尔迪/
Adilbek	/阿季利别克/
Adilbish	/阿吉尔毕希/
Adili	/阿迪利/
Adilian	/阿迪利昂/
Adilino	/阿迪利诺/
Adilio	/阿迪利奥/
Adilla	/阿迪亚/
Adillia	/阿迪利亚/
Adilovic	/阿迪洛维奇/
Adilshinov	/阿季利希诺夫/
Adilstam	/阿迪尔斯坦/
Adilturk	/阿迪勒蒂尔克/
Adilya	/阿季利娅/
Adilz	/阿迪尔斯/
Adima	/阿迪马/
Adimari	/阿迪马里/
Adimi	/阿迪米/
Adimico	/阿迪米科/
Adimola	/阿迪莫拉/
Adin	/阿丹/阿登/阿丁/埃丁/
Adina	/阿迪娜/阿迪纳/
Adinani	/阿迪纳尼/
Adinayev	/阿季纳耶夫/
Adine	/阿迪纳/
Ading	/阿丁/
Adinolfi	/阿迪诺尔菲/
Adinpitus	/阿丁皮图斯/
Adinsa	/阿丁萨/
Adio	/阿迪奥/
Adion	/阿迪翁/
Adip	/阿迪普/
Adipa	/阿迪帕/
Adipattla	/阿迪帕特拉/
Adipo	/阿迪波/
Adipola	/阿迪波拉/
Adiputro	/阿迪普特罗/
Adira	/阿迪拉/
Adireksan	/阿滴列山/
Adireksarn	/阿滴列山/
Adirosi	/阿迪罗西/
Adis	/阿迪斯/
Adisa	/阿迪萨/
Adisanli	/阿德桑勒/
Adisen	/阿德申/
Adiseshiah	/阿迪塞希亚/
Adison	/阿德松/
Adisonmez	/阿德森梅兹/
Adisubrata	/阿迪苏布拉塔/
Aditya	/阿迪蒂亚/
Adityendra	/阿迪廷德拉/
Adiuto	/阿迪乌托/
Adiutori	/阿迪乌托里/
Adivar	/阿德瓦尔/
Adiwoso	/阿迪沃索/
Adiyaman	/阿德亚曼/
Adiyev	/阿季耶夫/
Adjaba	/阿贾巴/
Adjadj	/阿贾杰/
Adjali	/阿贾利/
Adjani	/阿贾尼/
Adjaradji	/阿查拉吉/
Adjaye	/阿贾耶/
Adjei	/阿杰伊/
Adjeitey	/阿杰蒂/
Adjembo	/阿詹博/
Adjeng	/阿真/
Adjetey	/阿杰蒂/
Adji	/阿吉/
Adjia	/阿贾/
Adjie	/阿杰/
Adjitorop	/阿吉托罗普/
Adjo	/阿乔/
Adjomo	/阿乔莫/
Adjoudji	/阿朱吉/
Adjovi	/阿乔维/
Adjudeanu	/阿朱代亚努/
Adjuto	/阿德茹托/
Adkerson	/阿克森/
Adkin	/阿德金/
Adkins	/阿德金斯/
Adkinson	/阿德金森/
Adkisson	/阿基森/
Adla	/阿德拉/
Adlai	/阿德莱/
Adlam	/阿德拉姆/
Adlan	/阿德兰/
Adle	/阿德勒/
Adleff	/阿德勒夫/
Adleiba	/阿德列伊巴/
Adlen	/阿德朗/阿德伦/
Adler	/阿德莱尔/阿德勒/
Adlerberth	/阿德勒贝特/
Adlerbielke	/阿德勒比尔克/
Adlerblum	/阿德勒布卢姆/
Adlerborg	/阿德勒堡/
Adlerborn	/阿德勒博恩/
Adlercreutz	/阿德勒克罗伊茨/
Adlercron	/阿德勒克朗/
Adlers	/阿德勒斯/
Adlerstein	/阿德勒施泰因/阿德勒斯泰因/
Adlerstrahle	/阿德勒斯特罗勒/
Adlerz	/阿德勒斯/
Adlesic	/阿德莱希奇/
Adlex	/阿德莱克斯/
Adley	/阿德利/
Adlheid	/阿德列德/
Adli	/阿德勒/阿德利/
Adlig	/阿德勒/
Adling	/阿德林/
Adlivankin	/阿德利万金/
Adliye	/阿德利耶/
Adlof	/阿德洛夫/
Adloff	/阿德洛夫/
Adlofova	/阿德洛福娃/
Adlon	/阿德隆/
Adlouny	/阿德卢尼/
Adlova	/阿德洛娃/
Adlovits	/奥德洛维奇/
Adlt	/阿德尔特/
Adltova	/阿德尔托娃/
Adlum	/阿德勒姆/
Adlung	/阿德隆/
Adly	/阿兹利/
Adman	/阿德曼/
Admart	/阿德马特/
Admassie	/阿德马西埃/
Admassu	/阿德马苏/
Admete	/阿德梅特/
Admetlla	/阿德梅特利亚/
Admeto	/阿德梅托/
Admi	/阿德米/
Admil	/阿德米/
Admir	/阿德米尔/
Admira	/阿德米拉/
Admiral	/阿德米拉尔/
Admiralaud	/阿德米拉洛/
Admiralaut	/阿德米拉洛/
Admo	/阿德穆/
Admodarminto	/阿德莫达明托/
Admoni	/阿德莫尼/
Admouchnino	/阿德穆什尼诺/
Adna	/阿德纳/
Adnadevic	/阿德纳代维奇/
Adnan	/阿德南/
Adnane	/阿德南/
Adne	/阿德内/
Adnell	/阿德内尔/
Adner	/阿德纳/
Adnet	/阿德内/
Adney	/埃德尼/
Adno	/阿德诺/
Adnot	/阿德诺/
Ado	/阿杜/阿多/阿藤/阿土/安量/安昙/
Adoa	/阿多阿/
Adobati	/阿多巴蒂/
Adoboli	/阿多博利/
Adoc	/阿杜克/阿多克/
Adochitei	/阿多基采伊/阿多基泰伊/
Adodo	/阿多多/
Adodurov	/阿多杜罗夫/
Adof	/阿多夫/
Adoff	/阿多夫/
Adok	/阿杜克/阿多克/
Adoki	/阿直/安敕/
Adoko	/阿多科/
Adokpe	/阿多克佩/
Adol	/阿多尔/
Adolat	/阿多拉特/
Adolf	/阿道夫/
Adolfas	/阿道法斯/
Adolff	/阿道夫/
Adolfina	/阿道芬娜/
Adolfine	/阿道芬/
Adolfo	/阿道夫/阿道福/阿道弗/
Adolfov	/阿道福夫/
Adolfova	/阿道福娃/
Adolfovich	/阿道福维奇/
Adolfs	/阿道尔夫斯/
Adolfson	/阿道夫森/阿道夫松/
Adolfsson	/阿道夫松/
Adoli	/阿多利/
Adolia	/阿多利娅/
Adolii	/阿多利/
Adolini	/阿多利尼/
Adoliya	/阿多利娅/
Adolle	/阿多勒/
Adolph	/阿道夫/
Adolphe	/阿道夫/
Adolphi	/阿道菲/
Adolphine	/阿道菲娜/
Adolpho	/阿道弗/
Adolphs	/阿道夫斯/
Adolphsen	/阿道夫森/
Adolphson	/阿道夫松/
Adolphsson	/阿道夫松/
Adolphus	/阿道弗斯/
Adolpson	/阿道夫松/
Adolski	/阿多利斯基/
Adolsky	/阿多利斯基/
Adolt	/阿多尔特/
Adolvsson	/阿道夫松/
Adom	/阿多姆/
Adomadt	/阿多马特/
Adomaitis	/阿多迈蒂斯/
Adomat	/阿多马特/
Adomavichius	/阿多马维丘斯/
Adomeit	/阿多迈特/
Adomi	/阿多米/
Adomnicai	/阿多姆尼克伊/
Adomniti	/阿多姆尼齐/
Adomo	/阿多莫/
Adomokai	/阿多莫卡伊/
Adomonis	/阿多莫尼斯/
Adon	/阿东/
Adonai	/阿多奈/
Adonal	/阿多纳尔/
Adoncecchi	/阿东切基/
Adone	/阿多内/
Adoner	/阿多内/
Adonia	/阿多尼亚/
Adonian	/阿多尼昂/
Adonias	/阿多尼亚斯/
Adonijah	/阿多奈贾/
Adonin	/阿多宁/
Adoniram	/阿多奈拉姆/
Adonis	/阿多尼斯/
Adonnino	/阿东尼诺/
Adonon	/阿多农/
Adonts	/阿东茨/
Adony	/奥多尼/
Adonyi	/奥多尼/
Adoo	/阿杜/
Adoph	/阿多夫/
Ador	/阿多尔/
Adora	/阿多拉/
Adoradoras	/阿多拉多拉斯/
Adorante	/阿多兰特/
Adoranti	/阿多兰蒂/
Adoratski	/阿多拉茨基/
Adoratsky	/阿多拉茨基/
Adorazione	/阿多拉齐奥内/
Adore	/阿多尔/
Adorf	/阿多夫/
Adori	/阿多里/
Adorian	/阿多里安/阿多里昂/奥多里安/
Adoric	/阿多里奇/
Adorisio	/阿多里西奥/
Adorjan	/阿多尔然/
Adorjani	/阿多尔扎尼/奥多尔亚尼/
Adorjanyi	/奥多尔亚尼/
Adornato	/阿多尔纳托/
Adornetto	/阿多尔内托/
Adorni	/阿多尔尼/
Adorno	/阿多尔诺/
Adory	/阿多里/
Ados	/阿多斯/
Adosindo	/阿多辛多/
Adossama	/阿多萨马/
Adot	/阿多特/
Adotti	/阿多蒂/
Adou	/阿杜/
Adouan	/阿德万/
Adouane	/阿德万/
Adoue	/阿杜/阿杜埃/
Adoui	/阿德维/
Adouki	/阿杜基/
Adoul	/阿杜尔/
Adoula	/阿杜拉/
Adoum	/阿杜姆/
Adoumba	/阿敦巴/
Adounvo	/阿敦沃/
Adour	/阿杜尔/
Adourian	/阿杜里昂/
Adout	/阿杜/
Adouth	/阿杜特/
Adoutte	/阿杜特/
Adova	/阿多瓦/
Adovasio	/阿多瓦西奥/
Adovic	/阿多维奇/
Adow	/阿杜/
Adoyan	/阿多扬/
Adoyu	/阿多尤/
Adozinda	/阿多津达/
Adra	/阿德拉/
Adrada	/阿德拉达/
Adradas	/阿德拉达斯/
Adrado	/阿德拉多/
Adrados	/阿德拉多斯/
Adraga	/阿德拉加/
Adragao	/阿德拉冈/
Adragna	/阿德拉尼亚/
Adrahi	/阿德拉伊/
Adrait	/阿德雷/
Adrakh	/阿德拉赫/
Adram	/阿德拉姆/
Adran	/阿德兰/
Adranjan	/阿德兰詹/
Adrano	/阿德拉诺/
Adrar	/阿德拉尔/
Adrario	/阿德拉里奥/
Adras	/阿德拉斯/
Adrasto	/阿德拉斯托/
Adravanti	/阿德拉万蒂/
Adreani	/阿德雷亚尼/
Adrema	/阿德雷马/
Adren	/阿德伦/
Adret	/阿德雷/
Adrets	/阿德雷/
Adrex	/阿德雷/
Adrey	/阿德雷/
Adri	/阿德里/
Adria	/阿德里亚/
Adriaan	/阿德里安/
Adriaanszoon	/阿德里安松/
Adriaen	/阿德里安/
Adriaensz	/阿德里安斯/
Adrian	/阿德里安/阿德里昂/奥德里安/
Adriana	/阿德里安娜/阿德里亚纳/
Adriance	/阿德里安斯/
Adrianello	/阿德里亚内洛/
Adriani	/阿德里亚尼/
Adrianna	/阿德里安娜/
Adriano	/阿德里亚诺/
Adrianoff	/阿德里亚诺夫/
Adrianov	/阿德里阿诺夫/
Adrianovski	/阿德里阿诺夫斯基/
Adrianovsky	/阿德里阿诺夫斯基/
Adrianson	/阿德里安松/
Adriansson	/阿德里安松/
Adrianus	/阿德里亚努斯/
Adrianyi	/奥德里亚尼/
Adrianza	/阿德里安萨/
Adrianzon	/阿德里安松/
Adriao	/阿德里昂/
Adriasola	/阿德里亚索拉/
Adriatica	/阿德里亚蒂卡/
Adriatico	/阿德里亚蒂科/
Adriazola	/阿德里亚索拉/
Adrice	/阿德里斯/
Adrien	/阿德里安/阿德林/
Adrienne	/阿德里安娜/
Adrigan	/奥德里甘/
Adrijan	/阿德里扬/
Adrijana	/阿德里亚娜/
Adriko	/阿德里科/
Adrin	/阿德林/
Adrinal	/阿德里纳尔/
Adrio	/阿德里奥/
Adrion	/阿德里翁/
Adrisi	/伊德里斯/
Adriyan	/阿德里扬/
Adrizzoia	/阿德里佐亚/
Adrjanski	/阿德里安斯基/
Adro	/阿德罗/
Adroaldo	/阿德罗亚尔多/
Adrogna	/阿德罗尼亚/
Adrogue	/阿德罗格/
Adroher	/阿德罗埃尔/
Adrot	/阿德罗/
Adrouni	/阿德鲁尼/
Adrover	/阿德罗韦尔/
Adrovicz	/奥德罗维茨/
Adrualdo	/阿德鲁瓦尔多/
Adrup	/阿德鲁普/
Adry	/阿德里/
Adsat	/阿德萨特/
Adsay	/阿德萨伊/
Adsenius	/阿德塞纽斯/
Adshead	/阿谢德/
Adsiz	/阿德瑟兹/
Adsjo	/阿德舍/
Adski	/阿茨基/
Adsky	/阿茨基/
Adson	/阿德松/
Adstedt	/阿德斯泰特/
Adsten	/阿德斯滕/
Adsuar	/阿德苏瓦尔/
Adt	/阿特/
Adu	/阿杜/
Aduain	/阿杜瓦因/
Aduamah	/阿杜瓦马/
Aduanas	/阿杜瓦纳斯/
Aduard	/爱德华/
Aduashvili	/阿杜阿什维利/
Aducci	/阿杜奇/
Adugna	/阿杜尼亚/
Aduibi	/阿迪比/
Adukeyev	/阿杜克耶夫/
Aduko	/阿杜科/
Adula	/阿杜拉/
Aduloju	/阿杜洛朱/
Adulovic	/阿杜洛维奇/
Adulterini	/阿杜尔泰里尼/
Adum	/阿杜姆/
Adumi	/阿杜米/
Adumitresei	/阿杜米特雷塞伊/
Adumitroaiei	/阿杜米特罗阿耶伊/
Adunine	/阿杜尼内/
Adur	/阿杜尔/
Adura	/阿杜拉/
Aduriz	/阿杜里斯/
Adut	/阿杜特/
Adutt	/阿迪特/
Aduwo	/阿杜沃/
Aduyev	/阿杜耶夫/
Advadze	/阿德瓦泽/
Advani	/阿德瓦尼/
Advas	/阿德瓦斯/
Advenier	/阿德弗尼耶/
Advero	/阿德韦罗/
Adversi	/阿德韦尔西/
Advert	/阿德韦尔/
Advielle	/阿德维埃尔/
Advin	/阿德温/
Advincula	/阿德文库拉/
Advocatt	/阿德沃卡特/
Adwall	/阿德瓦尔/
Adwan	/阿德万/
Adwani	/阿达瓦尼/
Adwick	/阿迪克/
Adwok	/阿杜克/
Adwokat	/阿德沃卡/
Ady	/阿迪/奥迪/
Adya	/阿迪亚/
Adyan	/阿江/
Adyasuren	/阿迪亚苏伦/
Adye	/埃迪/
Adyebo	/阿德耶博/
Adygezal	/阿德格扎尔/
Adyrbekov	/阿德尔别科夫/
Adysh	/阿德什/
Adzaga	/阿扎加/
Adze	/阿泽/
Adzemovic	/阿哲莫维奇/
Adzhemyan	/阿杰米扬/
Adzhie	/阿吉埃/
Adzhiev	/阿吉耶夫/
Adzhiyev	/阿吉耶夫/
Adzhubei	/阿朱别伊/
Adzhubey	/阿朱别伊/
Adzic	/阿季奇/
Adzija	/阿吉亚/阿季亚/
Adzima	/阿齐马/
Adzir	/阿齐尔/
Adzori	/阿佐里/
Adzovic	/阿卓维奇/
Ae	/阿江/埃/哀/皑/艾/爱/隘/安拜/安闭/安慰/安闲/敢/阂/吾惠/吾瓮/涯/捱/霭/
Aeau	/埃奥/
Aeba	/飨场/飨庭/
Aebersold	/埃伯索尔德/
Aechi	/爱智/
Aechtner	/埃希特纳/
Aecio	/阿埃西奥/
Aeck	/埃克/
Aeckerle	/埃克勒/
Aecoboie	/阿埃科博耶/
Aedde	/埃迪/
Aedo	/阿埃多/
Aeed	/艾德/
Aeen	/迪恩/
Aegerter	/埃格特尔/
Aegidi	/埃吉迪/
Aegidius	/埃吉迪厄斯/埃吉迪乌斯/
Aehnelt	/埃内尔特/
Aehrenthal	/埃伦塔尔/
Aeisobe	/敢石部/
Aejmelaeus	/埃梅莱乌斯/
Aek	/额/厄/掖/腋/液/奕/
Aeka	/安平/
Ael	/阿埃尔/
Aeldert	/埃尔德特/
Aelenei	/阿埃莱内伊/
Aelfheah	/艾尔夫赫亚/
Aelfled	/埃尔夫勒德/
Aelfric	/阿尔弗里克/
Aelian	/艾利安/
Aelion	/阿埃利翁/
Aelisabetei	/阿埃利萨贝泰/
Aelita	/阿埃莉塔/
Aelred	/埃尔勒德/
Aelsson	/埃尔松/
Aelst	/阿尔斯特/
Aeltermann	/埃尔特曼/
Aelvoet	/阿尔富特/
Aemilianus	/埃米利亚努斯/
Aemmer	/阿埃梅尔/
Aeng	/樱/莺/撄/
Aengenendt	/恩格嫩特/
Aengeneyndt	/恩格奈因特/
Aengenheyster	/恩根海斯特/
Aengevelt	/恩格费尔特/
Aenlle	/阿恩列/
Aenoamahito	/吾瓮海人/
Aenoisobe	/敢石部/
Aeomizokukishi	/敢臣族岸/
Aepinus	/埃皮努斯/
Aeppel	/艾佩尔/
Aeppli	/埃普利/
Aerateurs	/阿埃拉特尔/
Aerila	/埃里拉/
Aerman	/阿埃尔曼/
Aerne	/埃内/
Aernout	/阿尔瑙特/
Aernum	/埃努姆/
Aerov	/阿耶罗夫/
Aerova	/阿埃罗娃/
Aerssen	/埃森/
Aert	/阿尔特/
Aertsen	/阿尔岑/
Aeschbacher	/埃施巴赫尔/埃希巴赫/
Aesop	/伊索/
Aet	/阿埃特/
Aeti	/阿埃季/
Aetios	/爱底奥斯/
Aetis	/阿埃蒂斯/
Aety	/阿埃季/
Af	/阿夫/
Afa	/阿法/
Afaba	/阿法瓦/
Afacan	/阿法詹/
Afachaire	/阿法谢尔/
Afaese	/阿费赛/
Afamasaga	/阿法马萨加/
Afan	/阿凡/
Afana	/阿法纳/
Afanador	/阿法纳多尔/
Afanas	/阿法纳斯/
Afanase	/阿法纳塞/
Afanasenko	/阿法纳先科/
Afanasev	/阿法纳西耶夫/
Afanasevich	/阿法纳西耶维奇/
Afanasi	/阿法纳西/
Afanasiadis	/阿法纳西亚季斯/
Afanasie	/阿法纳谢/
Afanasiev	/阿法纳谢夫/
Afanasievsky	/阿法纳西耶夫斯基/
Afanasije	/阿法纳西耶/
Afanasijif	/阿法纳西伊夫/
Afanasiya	/阿法纳西娅/
Afanasjew	/阿法纳西耶夫/
Afanasov	/阿法纳索夫/
Afanasovich	/阿法纳索维奇/
Afanasvan	/阿法纳斯旺/
Afanasy	/阿法纳西/
Afanasyev	/阿法纳西耶夫/
Afanasyeva	/阿法纳谢耶娃/
Afanasyevich	/阿法纳西耶维奇/
Afanasyevsky	/阿法纳西耶夫斯基/
Afande	/阿方德/
Afandi	/阿凡迪/
Afane	/阿凡/
Afanegus	/阿法尼古斯/
Afanyan	/阿法尼昂/
Afaque	/阿法克/
Afari	/阿法里/
Afasese	/阿法塞塞/
Afatsno	/阿法茨诺/
Afdal	/阿夫达尔/
Afecto	/阿费克托/
Afee	/埃菲/
Afeiche	/阿菲什/
Afeiteira	/阿费泰拉/
Afeltra	/阿费尔特拉/
Afendache	/阿芬达凯/
Afendik	/阿芬季克/
Afenduli	/阿芬杜利/
Afene	/阿费内/
Afenegus	/阿费内古斯/
Aferi	/阿费里/
Aferiat	/阿费里亚/
Aferwerki	/阿费沃尔基/
Afetouche	/阿费图什/
Afettouche	/阿费图什/
Afewerki	/阿费沃尔基/
Afework	/阿夫沃克/
Afezi	/阿费齐/
Affagard	/阿法加尔/
Affairoux	/阿费鲁/
Affan	/阿凡/
Affandi	/阿凡迪/
Affani	/阿法尼/
Affannati	/阿凡纳蒂/
Affannato	/阿凡纳托/
Affanni	/阿凡尼/
Affara	/阿法拉/
Affarano	/阿法拉诺/
Affatati	/阿法塔蒂/
Affatato	/阿法塔托/
Affaticati	/阿法蒂卡蒂/
Affatigato	/阿法蒂加托/
Affede	/阿费德/
Affeld	/阿费尔德/
Affelder	/阿费尔德尔/
Affeldt	/阿费尔特/
Affeltrange	/阿费尔特兰赫/
Affenita	/阿费尼塔/
Affergan	/阿费尔冈/
Afferica	/阿费里卡/
Affermann	/阿费尔曼/
Afferni	/阿费尔尼/
Affey	/阿费/
Affi	/阿菲/
Affichage	/阿菲沙热/
Affichard	/阿菲沙尔/
Affif	/阿菲夫/
Affifi	/阿菲菲/
Affifuddin	/阿菲夫丁/
Affinati	/阿菲纳蒂/
Affinita	/阿菲尼塔/
Affinito	/阿菲尼托/
Afflalo	/阿夫拉洛/
Afflard	/阿夫拉尔/
Afflatet	/阿夫拉泰/
Affleck	/阿弗莱克/
Affleckt	/阿夫莱克特/
Afflekt	/阿夫莱克特/
Afflerbach	/阿夫勒巴赫/
Afflitto	/阿弗利托/
Affoki	/阿福基/
Affoky	/阿福基/
Affolter	/阿福尔特/
Affoni	/阿福尼/
Affono	/阿福诺/
Affonseca	/阿丰塞卡/
Affonso	/阿丰索/
Affony	/阿福尼/
Affortet	/阿福泰/
Affortit	/阿福尔蒂/
Affouard	/阿富阿尔/
Affoue	/阿富埃/
Affourtit	/阿富尔蒂特/
Affra	/阿弗拉/
Affre	/阿弗尔/
Affres	/阿弗尔/
Affret	/阿弗雷/
Affri	/阿弗里/
Affricani	/阿弗里卡尼/
Affricano	/阿弗里卡诺/
Affronti	/阿弗龙蒂/
Affroy	/阿弗鲁瓦/
Afful	/阿富尔/
Affumicato	/阿富米卡托/
Affutou	/阿菲图/
Afgam	/阿夫加姆/
Afgan	/阿夫甘/
Afganly	/阿夫甘雷/
Afghan	/阿富汗/
Afghani	/阿富汗尼/
Afghazadeh	/阿夫加扎德/
Afi	/阿菲/
Afiana	/阿菲亚纳/
Afidi	/阿菲迪/
Afiero	/阿菲耶罗/
Afif	/阿菲夫/
Afife	/阿菲费/
Afifi	/阿菲菲/
Afiju	/阿菲朱/
Afilhado	/阿菲利亚多/
Afilipoaie	/阿菲利波阿耶/
Afimiya	/阿菲米娅/
Afimya	/阿菲米娅/
Afinger	/阿芬格/
Afinodor	/阿菲诺多尔/
Afinogen	/阿菲诺根/
Afinogenov	/阿菲诺格诺夫/
Afiouni	/阿菲乌尼/
Afiwa	/阿菲瓦/
Afiyaddin	/阿菲亚丁/
Afker	/阿夫克/
Afkhami	/阿夫哈米/
Aflak	/阿弗拉克/
Aflalo	/阿夫拉洛/
Aflaq	/阿弗拉克/
Aflat	/阿弗拉特/
Aflatet	/阿夫拉泰/
Afleche	/阿夫莱什/
Aflecht	/阿夫莱克特/
Aflorii	/阿弗洛里/
Afnain	/阿夫南/
Afnan	/阿夫南/
Afoito	/阿福伊托/
Afoki	/阿福基/
Afoky	/阿福基/
Afolabi	/阿福拉比/
Afon	/阿丰/
Afonasyev	/阿福纳西耶夫/
Afonchenko	/阿丰琴科/
Afonchikov	/阿丰奇科夫/
Afoni	/阿福尼/
Afonin	/阿福宁/
Afonja	/阿丰贾/
Afonkin	/阿丰金/
Afono	/阿福诺/
Afonov	/阿福诺夫/
Afonseca	/阿丰塞卡/
Afonski	/阿丰斯基/
Afonsky	/阿丰斯基/
Afonso	/阿丰索/
Afony	/阿福尼/
Afonyi	/奥福尼/
Aforki	/阿福尔基/
Afosno	/阿福斯诺/
Afourki	/阿费沃尔基/
Afr	/阿夫尔/
Afra	/阿弗拉/奥弗劳/
Afragola	/阿弗拉戈拉/
Afram	/阿夫拉姆/
Aframescu	/阿弗拉梅斯库/
Afranio	/阿弗拉尼奥/
Afranji	/阿弗兰吉/
Afraq	/阿弗拉克/
Afrasiab	/阿夫拉夏卜/
Afrasinei	/阿弗拉西内伊/阿弗勒瑟内伊/阿弗勒西内伊/
Afredzi	/阿夫雷齐/
Afreh	/阿夫雷/
Afreixo	/阿弗雷舒/
Afremov	/阿夫列莫夫/
Afrenie	/阿弗雷涅/
Afriat	/阿弗里亚/
Afric	/阿弗里奇/
Africa	/阿非利加/
Africano	/阿弗里卡诺/
Africanus	/阿菲利加努斯/阿弗里卡纳斯/
Afridi	/阿夫里迪/
Afrifa	/阿夫里法/
Afrikan	/阿夫里坎/
Afrine	/阿弗里纳/
Afrisiyab	/阿夫里西亚布/
Afriyie	/阿夫里耶/
Afro	/阿弗罗/
Afrodisi	/阿夫罗季西/
Afrodisy	/阿夫罗季西/
Afrodita	/阿弗萝迪塔/阿弗罗迪塔/
Afroditte	/阿弗罗迪特/
Afromeyev	/阿夫罗梅耶夫/
Afronie	/阿弗罗涅/
Afrosim	/阿夫罗西姆/
Afrosin	/阿夫罗辛/
Afrosinia	/阿夫罗西尼亚/
Afrosinya	/阿夫罗西尼亚/
Afryie	/阿夫里耶/
Afsanjani	/阿夫桑贾尼/
Afsar	/阿夫萨尔/阿夫沙尔/阿芙萨尔/
Afsargil	/阿夫沙尔吉尔/
Afsari	/阿夫萨里/
Afsaroglu	/阿夫沙尔奥卢/
Afsh	/阿夫什/
Afshar	/阿夫沙尔/
Afsin	/阿夫申/阿夫欣/
Aft	/阿夫特/
Aftab	/阿夫塔卜/
Aftabh	/阿夫塔卜/
Aftakh	/阿夫塔赫/
Aftalion	/阿夫塔利翁/
Aftan	/阿夫坦/
Aftanachi	/阿夫塔纳基/
Aften	/阿夫坚/
Aftene	/阿夫泰内/
Aftenie	/阿夫泰涅/
Afteniuk	/阿夫捷纽克/
Aftenyuk	/阿夫捷纽克/
Aftim	/阿夫蒂姆/
Aftin	/奥夫廷/
Afting	/阿夫廷/
Aftodor	/阿夫托多尔/
Aftonasyev	/阿夫托纳西耶夫/
Afuera	/阿富埃拉/
Afumi	/淡海/近江/
Afuri	/泥障/
Afwerki	/阿费沃尔基/
Afwroky	/阿费沃尔基/
Afxentiou	/阿夫克森蒂乌/
Afxentis	/阿夫克森蒂斯/
Afza	/阿夫扎/
Afzal	/阿夫扎尔/阿夫扎勒/
Afzali	/阿夫扎利/
Afzalov	/阿夫扎洛夫/
Afzeen	/阿夫森/
Afzelius	/阿夫塞利乌斯/
Ag	/阿格/
Aga	/阿河/阿贺/阿加/阿迦/淡川/淡河/何/英贺/英加/
Aga-Khan	/阿迦·汗/
Agababa	/阿加巴巴/
Agababaev	/阿加巴巴耶夫/
Agababian	/阿加巴比扬/
Agababov	/阿加巴博夫/
Agababyan	/阿加巴比扬/
Agabalyan	/阿加巴良/
Agabalyants	/阿加巴良茨/
Agabawi	/阿格巴维/
Agabay	/阿阿巴伊/
Agabegyan	/阿加别吉扬/
Agabek	/阿加别克/
Agabekov	/阿加别科夫/
Agabekyan	/阿加别基扬/
Agabeyan	/阿加贝扬/
Agabeyoglu	/阿阿贝伊奥卢/
Agabi	/阿加比/
Agabigun	/阿阿比金/
Agabiti	/阿加比蒂/
Agabitini	/阿加比蒂尼/
Agabito	/阿加比托/
Agabo	/阿加沃/
Agabolaogly	/阿加博劳格雷/
Agabriel	/阿加布里埃尔/
Agacan	/阿阿詹/
Agacayak	/阿阿恰亚克/
Agacci	/阿加奇/
Agacdiken	/阿阿奇迪肯/
Agace	/阿加斯/
Agachan	/阿阿奇汗/
Agache	/阿加凯/阿加什/
Agachi	/阿加基/
Agaciak	/阿加恰克/
Agacik	/阿阿哲克/
Agacikoglu	/阿阿哲克奥卢/
Agacz	/奥加茨/
Agada	/阿加达/
Agades	/阿加代斯/
Agadzhan	/阿加占/
Agadzhanian	/阿加贾尼扬/
Agadzhanov	/阿加贾诺夫/
Agadzhanyan	/阿加贾尼扬/
Agaev	/阿加耶夫/
Agafa	/阿加法/
Agafangel	/阿加凡格尔/
Agafia	/阿加菲娅/
Agaficioaia	/阿加菲奇瓦娅/
Agaficioaiae	/阿加菲奇瓦亚耶/
Agafija	/阿加菲娅/
Agafisoaei	/阿加菲索阿埃伊/
Agafitei	/阿加菲采伊/
Agafodor	/阿加福多尔/
Agafokliya	/阿加福克利娅/
Agafon	/阿加丰/
Agafonik	/阿加福尼克/
Agafonika	/阿加福妮卡/
Agafonoff	/阿加福诺夫/
Agafonov	/阿加福诺夫/
Agafonovich	/阿加福诺维奇/
Agafopod	/阿加福波德/
Agafopus	/阿加福普斯/
Agafoshin	/阿加福申/
Agafya	/阿加菲娅/
Agagian	/阿加吉安/
Agagianian	/阿加贾尼安/
Agagil	/阿阿吉尔/
Agagu	/阿加古/
Agaguseinov	/阿加古谢伊诺夫/
Agaguseynov	/阿加古谢伊诺夫/
Agagyul	/阿加久利/
Agah	/阿加/
Agaho	/上穗/
Agai	/阿高伊/
Again	/阿盖恩/
Agaisenov	/阿盖谢诺夫/
Agaisse	/阿盖塞/
Agaj	/阿加伊/
Agaja	/阿加扎/
Agajan	/阿加扬/
Agajyellew	/阿加吉耶卢/
Agakay	/阿阿卡伊/
Agakhanov	/阿加哈诺夫/
Agakhi	/阿加希/
Agakov	/阿加科夫/
Agal	/阿高尔/阿加尔/阿贾勒/
Agala	/阿加拉/
Agalakov	/阿加拉科夫/
Agalar	/阿阿拉尔/阿加拉尔/
Agalede	/阿加勒德/
Agaledes	/阿加莱德/
Agaletski	/阿加列茨基/
Agaletsky	/阿加列茨基/
Agalide	/阿加利德/
Agaltsev	/阿加利采夫/
Agaltsov	/阿加利佐夫/
Agaly	/阿加雷/
Agama	/阿加马/
Agamali	/阿加马利/
Agamalov	/阿加马洛夫/
Agamalova	/阿加马洛娃/
Agamaly	/阿加马雷/
Agamalyan	/阿加马良/
Agamas	/阿加马斯/
Agamben	/阿甘本/
Agamcam	/阿阿姆恰姆/
Agamemnon	/阿伽门农/
Agamennone	/阿加门诺内/
Agamenon	/阿加梅农/
Agami	/阿加米/
Agamzo	/阿加姆索/
Agan	/阿安/阿甘/
Aganana	/阿加纳纳/
Aganaye	/阿加纳耶/
Aganbegyan	/阿甘别吉扬/
Aganbekyan	/阿甘别基扬/
Agane	/阿金/
Aganemmon	/阿加奈蒙/
Aganer	/阿阿内尔/
Aganezov	/阿加涅佐夫/
Agani	/阿贾尼/
Aganimov	/阿加尼莫夫/
Aganin	/阿加宁/
Agano	/上野/吾野/
Aganoglu	/阿安奥卢/
Aganon	/阿加尼翁/
Aganov	/阿加诺夫/
Aganovic	/阿加诺维奇/
Aganso	/阿甘索/
Agante	/阿甘特/
Aganzo	/阿甘索/
Agao	/阿冈/
Agaoglu	/阿阿奥卢/
Agap	/阿加普/
Agapa	/阿加帕/
Agape	/阿加佩/
Agapescu	/阿加佩斯库/
Agapey	/阿加佩/
Agapeya	/阿加佩娅/
Agapi	/阿加皮/
Agapia	/阿加皮亚/阿加皮娅/
Agapiade	/阿加皮亚德/
Agapida	/阿加皮达/
Agapie	/阿加皮耶/
Agapiescu	/阿加皮耶斯库/
Agapiev	/阿加皮耶夫/
Agapii	/阿加皮/
Agapij	/阿加皮/
Agapija	/阿加皮娅/
Agapije	/阿加皮耶/
Agapin	/阿加平/
Agapion	/阿加皮翁/
Agapios	/阿加皮奥/
Agapit	/阿加皮/阿加皮特/
Agapiti	/阿加皮蒂/
Agapitidis	/阿加皮蒂季斯/
Agapito	/阿加皮托/
Agapitos	/阿加皮托斯/
Agapitov	/阿加皮托夫/
Agapiya	/阿加皮娅/
Agapoff	/阿加波夫/
Agapon	/阿加蓬/
Agapov	/阿加波夫/
Agapova	/阿加波娃/
Agar	/阿阿尔/阿加/阿加尔/
Agarabaghi	/阿加拉巴吉/
Agarantan	/阿阿兰坦/
Agard	/阿加德/阿加尔/
Agardh	/阿加德/
Agardi	/阿加尔迪/奥加尔迪/
Agardy	/奥加尔迪/
Agareala	/阿加雷亚拉/
Agarev	/阿加列夫/
Agarez	/阿加雷斯/
Agari	/上里/上利/
Agarici	/阿加里奇/
Agarie	/东江/
Agariishi	/上石/
Agarijo	/东城/
Agarimatsu	/上松/
Agarinis	/阿加里尼斯/
Agariya	/阿加里娅/
Agarizuma	/上妻/
Agarkov	/阿加尔科夫/
Agaronov	/阿加罗诺夫/
Agaronyan	/阿加罗尼扬/
Agaros	/阿加罗斯/
Agarossi	/阿加罗西/
Agarrabeitia	/阿加拉韦蒂亚/
Agarrat	/阿加拉/
Agarrista	/阿加里斯塔/
Agartan	/阿阿尔坦/
Agartz	/阿加尔茨/
Agarwal	/阿加瓦尔/
Agarzuza	/阿加尔苏萨/
Agas	/阿高什/
Agasaly	/阿加萨雷/
Agasanu	/阿格沙努/
Agasar	/阿加萨尔/
Agasarov	/阿加萨罗夫/
Agasaryan	/阿加萨良/
Agashin	/阿加申/
Agashina	/阿加申娜/
Agashkov	/阿加什科夫/
Agasi	/阿加西/
Agasian	/阿加西安/阿加相/
Agasiyev	/阿加西耶夫/
Agasiyevich	/阿加西耶维奇/
Agasse	/阿加斯/
Agassi	/阿加西/
Agassian	/阿加西安/
Agassini	/阿加西尼/
Agassis	/阿加西/
Agassiz	/阿加西/阿加西斯/
Agastein	/阿加施泰因/
Agastin	/阿加斯坦/
Agasucci	/阿加苏奇/
Agasyan	/阿加相/
Agat	/阿加/
Agata	/阿加塔/阿片/阿形/安方/安形/县/县田/扬田/英多/英贺田/英太/英田/
Agatai	/县居/
Agatainukai	/县犬养/
Agatakimi	/县君/
Agatamaro	/县麻吕/
Agatamori	/县守/
Agatanoatae	/县直/
Agatanomitsukai	/县使/
Agatanomiyatsuko	/县造/
Agatanoomi	/县使/
Agatanushi	/县主/
Agatanushisakito	/县主前利/
Agatao	/阿加唐/
Agatatsukai	/县使/
Agate	/阿加特/
Agatello	/阿加泰洛/
Agatensi	/阿加滕西/
Agatha	/阿加莎/
Agathangelou	/阿加桑耶卢/
Agathanghelou	/阿加桑耶卢/
Agatharchus	/阿加萨霍斯/
Agathe	/阿加特/
Agathon	/阿加顿/
Agati	/阿加蒂/
Agatia	/阿加蒂娅/
Agatic	/阿加蒂奇/
Agatija	/阿加蒂娅/
Agatini	/阿加蒂尼/
Agatomea	/阿加托梅亚/
Agaton	/阿加顿/
Agatone	/阿加托内/
Agatoni	/阿加托尼/
Agatonik	/阿加托尼克/
Agatonovic	/阿加托诺维奇/
Agatonsson	/阿加顿松/
Agator	/阿加托尔/
Agatos	/阿加托斯/
Agatsuma	/阿我妻/上妻/我妻/吾妻/扬妻/
Agatz	/阿加茨/
Agav	/阿加夫/
Agava	/阿加瓦/
Agave	/阿加弗/
Agavelyan	/阿加韦良/
Agaverdi	/阿阿韦尔迪/
Agavni	/阿加夫尼/
Agavnov	/阿加夫诺夫/
Agavriloae	/阿加弗里洛阿耶/
Agavva	/阿加瓦/
Agawa	/阿川/阿河/淡川/淡河/溃川/溃河/蛙川/吾河/
Agay	/阿盖/阿高伊/
Agayan	/阿加扬/
Agayar	/阿加亚尔/
Agayev	/阿加耶夫/
Agaz	/阿加斯/
Agazadeh	/阿加扎德/
Agazarian	/阿贾扎里安/
Agazia	/阿加齐亚/
Agazio	/阿加齐奥/
Agazoni	/阿高佐尼/
Agazzani	/阿加扎尼/
Agazzari	/阿加扎里/
Agazzi	/阿加齐/
Agazzini	/阿加齐尼/
Agba	/阿巴/
Agbaba	/阿格巴巴/
Agbamuche	/阿巴穆谢/
Agbaniakai	/阿巴尼亚卡伊/
Agbayani	/阿格瓦亚尼/
Agbe	/阿贝/
Agbeck	/阿格贝克/
Agbeja	/阿贝贾/
Agbeka	/阿贝卡/
Agbemudia	/阿贝穆迪亚/
Agbenowossi	/阿贝诺沃西/
Agbenoxevi	/阿贝诺克塞维/
Agbesi	/阿贝西/
Agbetiafa	/阿贝蒂亚法/
Agbetra	/阿贝特拉/
Agbeyome	/阿贝约梅/
Agble	/阿布莱/
Agblemagnon	/阿布莱马尼翁/
Agbo	/阿博/
Agbobli	/阿博布利/
Agbobu	/阿波布/
Agbodjan	/阿博詹/
Agbodu	/阿波杜/
Agbogboli	/阿博博利/
Agboli	/阿博利/
Agboola	/阿布拉/
Agbor	/阿博尔/阿格博尔/
Agboton	/阿格博东/
Agbottah	/阿博塔/
Agboyibo	/阿博伊博/
Agbozouhoue	/阿博祖惠/
Agbrink	/阿格布林克/
Agbro	/阿格布罗/
Agbuga	/阿格布加/
Agca	/阿贾/阿恰/
Agcasar	/阿贾沙尔/
Agce	/阿切/
Agcelik	/阿切勒克/
Agda	/阿格达/
Agdamski	/阿格达姆斯基/
Agdamskii	/阿格达姆斯基/
Agde	/阿格德/
Agder	/阿格德/
Agdern	/阿格德恩/
Agdin	/阿格丁/
Agdur	/阿格杜尔/
Agdzha	/阿格贾/
Age	/阿格/阿赫/奥尼/奥耶/扬/
Agea	/阿赫亚/阿贾/
Ageasse	/阿雅斯/
Ageba	/上场/
Ageback	/阿格贝克/
Agebark	/阿格巴克/
Agebert	/阿格贝特/
Agebjar	/阿格比耶尔/
Agebjers	/阿格比耶斯/
Agebrandt	/阿格布兰特/
Agebro	/阿格布罗/
Ageby	/阿格比/
Agedal	/阿格达尔/
Agede	/阿盖德/
Ageder	/阿热代/
Agederian	/阿热代里安/
Agee	/阿吉/
Ageev	/阿格耶夫/
Agefjard	/阿格菲耶德/
Ageha	/上羽/
Agehara	/扬原/
Ageharitsukuri	/幄作/
Agehed	/阿格赫德/
Ageheim	/阿格海姆/
Agehorn	/阿格霍恩/
Agei	/阿盖/阿热/上井/
Ageichev	/阿盖切夫/
Ageikin	/阿盖金/
Ageishi	/上石/扬石/
Agejas	/阿赫哈斯/
Ageki	/阿下喜/
Ageklint	/阿格克林特/
Agekyan	/阿格基扬/
Agel	/阿格尔/阿热尔/
Agelan	/阿赫兰/
Ageland	/阿格兰/
Agelao	/阿杰劳/
Agelet	/阿赫莱特/阿热莱/
Agelfors	/阿格尔福什/
Agelid	/阿格利德/
Agelii	/阿格利/
Agelija	/阿盖利娅/
Agelin	/阿格林/
Agelis	/阿格利斯/
Agell	/阿格尔/
Agelli	/阿杰利/
Agello	/阿杰洛/
Agelopoulos	/阿耶洛普洛斯/
Agelstad	/阿格尔斯塔德/
Agelstam	/阿格尔斯坦/
Agemaki	/扬卷/总角/
Ageman	/阿格曼/
Agemass	/阿杰马斯/
Agematsu	/上松/
Agemi	/上见/
Agemian	/阿杰米安/
Agemolu	/阿杰莫卢/
Agemori	/上森/
Agen	/阿根/
Agenais	/阿热奈/
Agenas	/阿格奈斯/
Agenback	/阿根贝克/
Agenberg	/阿根贝里/
Agenbright	/阿金布赖特/
Agenet	/阿热内/
Agenie	/阿热尼/
Agenin	/阿热南/
Agenir	/阿格尼尔/
Agenis	/阿热尼/
Agenjo	/阿亨霍/
Agenmark	/阿根马克/
Ageno	/阿杰诺/上野/
Agenongha	/阿格农哈/
Agenongka	/阿盖农卡/
Agenor	/阿格诺尔/阿热诺尔/
Agenorov	/阿格诺罗夫/
Agenskog	/阿根斯科格/
Agenso	/阿亨索/
Agent	/阿真特/
Agentov	/阿根托夫/
Agentur	/阿根图尔/
Ageo	/上尾/
Ageorge	/阿乔治/
Ageorges	/阿乔治/
Ager	/阿埃尔/阿格/阿赫尔/阿热/埃杰/
Agerasia	/阿杰拉西亚/
Agerbark	/阿格巴克/
Agerbeck	/阿格贝克/
Agerberg	/阿格贝里/
Agerberth	/阿格贝特/
Agerbjer	/阿格比耶/
Agerblad	/阿格布拉德/
Agerbo	/阿格博/
Agerbring	/阿格布林/
Agerby	/阿格比/
Agerfal	/阿盖法尔/
Agerfeldt	/阿格费尔特/
Agerfjord	/阿格菲尤德/
Agerhall	/阿格赫尔/
Agerheim	/阿格海姆/
Agerhjelm	/阿格耶尔姆/
Agerholm	/阿格霍尔姆/
Ageri	/上利/
Agering	/阿格林/
Agerkrans	/阿格克兰斯/
Agerlid	/阿格利德/
Agerlo	/阿格洛/
Agerman	/阿格曼/
Agero	/阿格勒/阿赫罗/
Agerola	/阿杰罗拉/
Ageron	/阿热龙/
Agerskans	/阿格斯坎斯/
Agerskov	/阿格斯科夫/
Agerstam	/阿格斯坦/
Agerstedt	/阿格斯泰特/
Agerstig	/阿格斯蒂格/
Agerstrand	/阿格斯特兰德/
Agerstrom	/阿格斯特伦/
Agert	/阿格特/
Agerter	/埃格特尔/
Agerud	/阿格鲁德/
Agerup	/阿厄鲁普/阿格鲁普/
Agervald	/阿格瓦尔德/
Ageshchev	/阿格谢夫/
Ageshev	/阿格舍夫/
Ageshin	/阿格申/
Agesilas	/阿热西拉/
Agesilaus	/阿格西劳斯/
Agesitaos	/阿耶西塔奥斯/
Agesta	/阿杰斯塔/
Agestam	/阿格斯坦/
Agestedt	/阿格斯泰特/
Agestrand	/阿格斯特兰德/
Agestrom	/阿格斯特伦/
Aget	/阿热/
Ageta	/举田/上田/
Agethen	/阿格滕/
Agetoft	/阿格托夫特/
Ageton	/阿吉顿/
Agetsuma	/上妻/
Agevik	/阿格维克/
Agey	/阿吉/
Ageya	/扬屋/
Ageyenko	/阿格延科/
Ageyev	/阿格耶夫/
Ageyevski	/阿格耶夫斯基/
Ageyevsky	/阿格耶夫斯基/
Agfalvi	/阿格福尔维/
Agfors	/阿格福什/
Agforsen	/阿格福森/
Agg	/阿格/
Aggad	/阿加德/
Aggar	/阿加尔/
Aggazzotti	/阿加佐蒂/
Agge	/阿格/
Aggebo	/阿格博/
Aggebrandt	/阿格布兰特/
Aggebrink	/阿格布林克/
Aggefors	/阿格福什/
Aggei	/阿盖/
Aggel	/阿格尔/
Aggeler	/阿格勒/
Aggemo	/阿格莫/
Aggenas	/阿格奈斯/
Aggenberg	/阿根贝里/
Agger	/阿格/
Aggerborg	/阿格堡/
Aggernaes	/阿格奈斯/
Aggerod	/阿格勒德/
Aggerstad	/阿格斯塔德/
Aggeryd	/阿格吕德/
Aggeskog	/阿格斯科格/
Aggeson	/阿格松/
Aggestad	/阿格斯塔德/
Aggestam	/阿格斯坦/
Aggesten	/阿格斯滕/
Aggestig	/阿格斯蒂格/
Aggestrup	/阿格斯特鲁普/
Aggett	/阿盖特/
Aggeu	/阿热乌/
Aggeyenko	/阿格延科/
Aggeyev	/阿格耶夫/
Agghazi	/阿格哈齐/
Aggioli	/阿焦利/
Aggod	/奥戈德/
Aggott	/阿戈特/
Aggradi	/阿格拉迪/
Aggrey	/阿格雷/
Aggri	/阿格里/
Aggring	/阿格林/
Aggunlu	/阿金吕/
Agh	/阿格/
Agha	/阿迦/
Aghabari	/阿加巴里/
Aghabeyan	/阿加贝扬/
Aghadowey	/阿赫杜伊/
Aghaganian	/阿加加尼安/
Aghah	/阿迦/
Aghaie	/阿加耶/
Aghanim	/阿加南/
Aghanloo	/安卢/
Aghar	/阿加尔/
Aghasi	/阿加西/
Aghayan	/阿加扬/
Aghazadeh	/阿加扎德/
Aghbal	/阿格巴尔/
Aghbari	/阿格巴里/
Aghbary	/阿格巴里/
Aghed	/阿格赫德/
Agheden	/阿格赫登/
Aghedu	/阿格迪/
Agheici	/阿盖伊奇/
Aghemio	/阿盖米奥/
Aghemo	/阿盖莫/
Agheorghesei	/阿格奥尔盖塞伊/
Agheorghiesei	/阿格奥尔盖塞伊/
Agher	/阿格尔/
Aghetoni	/阿盖托尼/
Aghiana	/阿吉亚纳/
Aghil	/阿吉勒/
Aghilar	/阿吉拉尔/
Aghilarre	/阿吉拉雷/
Aghilone	/阿吉洛内/
Aghina	/阿吉纳/
Aghiniei	/阿吉涅伊/
Aghion	/阿吉翁/
Aghito	/阿吉托/
Aghlabid	/阿格拉比德/
Aghnides	/阿格尼德/
Agholm	/阿格霍尔姆/
Agholme	/阿格霍尔默/
Agi	/阿吉/阿木/阿希/安城/
Agiami	/阿贾米/
Agib	/阿吉卜/
Agibalov	/阿吉巴洛夫/
Agic	/阿吉奇/
Agica	/阿吉察/阿吉卡/
Agichev	/阿吉切夫/
Agid	/阿吉德/
Agide	/阿吉德/
Agidius	/阿吉迪乌斯/埃吉迪乌斯/
Agier	/阿吉耶/
Agil	/阿吉/
Agild	/阿吉尔德/
Agilgat	/阿厄尔加特/
Agilonu	/阿厄勒尼/
Agilulfo	/阿吉卢尔福/
Agim	/阿厄姆/阿吉姆/
Agiman	/阿吉曼/
Agin	/阿金/阿欣/
Agina	/阿艺那/
Aginah	/阿吉纳/
Agincourt	/阿然古/
Aginger	/阿金格/
Agins	/阿金斯/
Aginski	/阿金斯基/
Aginsky	/阿金斯基/
Agiobu	/阿焦布/
Agir	/阿厄尔/
Agirbasli	/阿厄尔巴什勒/
Agirbayraktar	/阿厄尔巴伊拉克塔尔/
Agirbiceanu	/阿格尔比恰努/
Agirdas	/阿厄尔达什/
Agirer	/阿厄雷尔/
Agirgil	/阿厄尔吉尔/
Agirkan	/阿厄尔坎/
Agirnas	/阿厄尔纳斯/
Agirnasli	/阿厄尔纳斯勒/
Agirtan	/阿厄尔坦/
Agirtas	/阿厄尔塔什/
Agis	/阿厄什/阿吉斯/阿希斯/
Agish	/阿吉什/
Agishev	/阿吉舍夫/
Agisson	/阿吉松/
Agita	/阿吉塔/
Agitoo	/腮尾/
Agiu	/阿久/
Agius	/阿吉厄斯/阿吉乌斯/阿希乌斯/
Agiwa	/阿吉瓦/
Agiyevich	/阿吉耶维奇/
Agkatsev	/阿赫卡采夫/
Aglac	/阿拉奇/
Agladze	/阿格拉泽/
Aglae	/阿格莱/
Aglaea	/阿格拉亚/
Aglai	/阿格莱/
Aglaia	/阿格拉亚/
Aglaida	/阿格莱达/
Aglamaz	/阿拉马兹/
Aglamazov	/阿格拉马佐夫/
Aglaya	/阿格拉娅/
Aglen	/阿格伦/
Agler	/阿格勒尔/
Aglert	/阿格勒特/
Agli	/阿勒/阿利/
Aglialoro	/阿利亚洛罗/
Agliani	/阿利亚尼/
Agliano	/阿利亚诺/
Agliardi	/阿利亚尔迪/
Agliastro	/阿利亚斯特罗/
Agliata	/阿利亚塔/
Agliati	/阿利亚蒂/
Agliberto	/阿利贝托/
Aglieco	/阿列科/
Aglieri	/阿列里/
Aglierulo	/阿列鲁洛/
Aglietta	/阿列塔/
Aglietti	/阿列蒂/
Aglietto	/阿列托/
Aglija	/阿格利娅/
Aglina	/阿格利娜/
Aglinger	/阿格林格/
Aglini	/阿利尼/
Aglio	/阿利奥/
Agliocchi	/阿廖基/
Aglione	/阿廖内/
Aglioti	/阿廖蒂/
Aglitski	/阿格利茨基/
Aglitsky	/阿格利茨基/
Aglitti	/阿利蒂/
Agman	/阿格曼/
Agmon	/阿格蒙/
Agmund	/阿格蒙德/
Agn	/阿根/昂/
Agna	/阿格娜/
Agnaletti	/阿尼亚莱蒂/
Agnalv	/昂内尔夫/
Agnan	/阿尼昂/
Agnani	/阿尼亚尼/
Agnano	/阿尼亚诺/
Agnar	/阿格纳尔/昂纳尔/
Agnard	/阿尼亚尔/
Agnarez	/阿格纳雷斯/
Agnat	/阿格纳特/
Agnatelli	/阿尼亚泰利/
Agnati	/阿尼亚蒂/
Agnayev	/阿格纳耶夫/
Agnberger	/昂贝里耶/
Agnblad	/昂布拉德/
Agndal	/昂达尔/
Agne	/阿格尼/阿涅/昂内/
Agneau	/阿尼奥/
Agnebo	/昂内博/
Agneborg	/昂内堡/
Agneby	/昂内比/
Agnefall	/昂内法尔/
Agnefors	/昂内福什/
Agnefur	/昂内富尔/
Agnekil	/昂内希尔/
Agneklev	/昂内克莱夫/
Agnel	/阿涅尔/
Agneles	/阿涅勒/
Agnell	/昂内尔/
Agnellet	/阿涅莱/
Agnelli	/阿涅利/
Agnellini	/阿涅利尼/
Agnellino	/阿涅利诺/
Agnello	/阿格内洛/阿涅洛/
Agnelluzzi	/阿涅卢齐/
Agnelo	/阿格内洛/
Agnely	/阿涅利/
Agneni	/阿涅尼/
Agner	/阿格纳/昂纳/
Agneray	/阿涅雷/
Agnerling	/昂纳林/
Agnerstam	/昂纳斯坦/
Agnerstedt	/昂纳斯泰特/
Agnerud	/昂内鲁德/
Agnes	/阿格奈什/阿格内斯/阿格尼丝/阿涅斯/阿涅丝/昂内斯/
Agnesa	/阿格内莎/阿格涅萨/
Agnese	/阿格内塞/阿涅塞/
Agnesi	/阿涅西/
Agnesia	/阿格内西亚/
Agnesili	/阿涅西利/
Agnesina	/阿涅西纳/
Agnesjo	/昂内舍/
Agneskog	/昂内斯科格/
Agnesotti	/阿涅索蒂/
Agnessa	/阿格涅萨/
Agnestal	/昂内斯托尔/
Agnestam	/昂内斯坦/
Agnestedt	/昂内斯泰特/
Agnestig	/昂内斯蒂格/
Agneta	/阿涅塔/
Agnetas	/昂内塔斯/
Agnetchinski	/阿格涅钦斯基/
Agnete	/阿格妮特/
Agnetis	/阿涅蒂斯/
Agnetti	/阿涅蒂/
Agneus	/昂内乌斯/
Agnevald	/昂内瓦尔德/
Agnevik	/昂内维克/
Agnew	/阿格纽/
Agneya	/阿格涅娅/
Agneza	/阿格内扎/
Agnfors	/昂福什/
Agnhage	/昂哈格/
Agnhagen	/昂哈根/
Agni	/阿格尼/
Agniaro	/阿尼亚罗/
Agniashvili	/阿格尼阿什维利/
Agnica	/阿格妮察/
Agnich	/阿格尼奇/
Agniel	/阿尼埃尔/
Agnier	/阿尼耶/
Agnifili	/阿尼菲利/
Agnii	/阿格尼/
Agnija	/阿格尼娅/
Agnini	/阿尼尼/
Agnisetta	/阿尼塞塔/
Agnivtsev	/阿格尼夫采夫/
Agniya	/阿格尼娅/
Agno	/阿尼奥/
Agnocchetti	/阿尼奥凯蒂/
Agnolesi	/阿尼奥莱西/
Agnolet	/阿尼奥莱特/
Agnoleti	/阿尼奥莱蒂/
Agnoletti	/阿尼奥莱蒂/
Agnoletto	/阿尼奥莱托/
Agnoli	/阿尼奥利/
Agnolini	/阿尼奥利尼/
Agnolo	/阿尼奥洛/
Agnolon	/阿尼奥隆/
Agnoloni	/阿尼奥洛尼/
Agnolozzi	/阿尼奥洛齐/
Agnolucci	/阿尼奥卢奇/
Agnoluzzi	/阿尼奥卢齐/
Agnone	/阿尼奥内/
Agnoni	/阿尼奥尼/
Agnozzi	/阿尼奥齐/
Agnsater	/昂塞特/
Agnus	/阿格纳斯/阿尼斯/
Agnusdei	/阿纽斯代伊/
Agnuzzi	/阿纽齐/
Agnvall	/昂瓦尔/
Ago	/阿戈/安居/淡川/淡河/吾乡/英虞/
Agoas	/阿戈阿斯/
Agobert	/阿戈贝尔/
Agobet	/阿戈贝/
Agoccioni	/阿戈乔尼/
Agocs	/奥戈奇/
Agocsy	/奥戈奇/
Agoes	/阿古斯/阿约斯/
Agoglia	/阿戈利亚/
Agoglitta	/阿戈利塔/
Agogna	/阿戈尼亚/
Agogue	/阿戈盖/
Agoin	/安居稳/安居院/
Agol	/阿戈尔/
Agola	/阿戈拉/
Agoli	/阿戈利/
Agolia	/阿戈利亚/
Agolini	/阿戈利尼/
Agolino	/阿戈利诺/
Agolli	/阿戈利/
Agomeri	/阿戈梅里/
Agon	/阿贡/
Agonas	/奥戈纳什/
Agondjo	/阿贡乔/
Agonia	/阿戈尼亚/
Agoora	/阿朱拉/
Agop	/阿戈/阿戈普/
Agopian	/阿戈皮安/
Agopoff	/阿戈波夫/
Agopovich	/阿戈波维奇/
Agopsa	/阿戈普萨/阿戈普沙/
Agopyan	/阿戈皮扬/
Agora	/阿戈拉/
Agordela	/阿戈德拉/
Agordo	/阿戈尔多/
Agoren	/阿厄伦/
Agoric	/阿戈里奇/
Agorio	/阿戈里奥/
Agorodo	/阿戈罗多/
Agorreta	/阿戈雷塔/
Agoru	/奥戈鲁/
Agos	/阿戈斯/
Agosescu	/阿戈塞斯库/
Agoshima	/阿子岛/
Agoshkov	/阿戈什科夫/
Agost	/阿戈什特/
Agosta	/阿戈斯塔/
Agostara	/阿戈斯塔拉/
Agostay	/阿戈什陶伊/
Agosteo	/阿戈斯泰奥/
Agosthazy	/阿戈什特哈齐/
Agosti	/阿戈斯蒂/
Agostinacchio	/阿戈斯蒂纳基奥/
Agostinelli	/阿戈斯蒂内利/
Agostinha	/阿戈斯蒂尼亚/
Agostinho	/阿戈什蒂纽/
Agostini	/阿戈斯蒂尼/
Agostinis	/阿戈什蒂尼什/阿戈斯蒂尼斯/
Agostino	/阿戈斯蒂诺/
Agostinone	/阿戈斯蒂诺内/
Agostinoni	/阿戈斯蒂诺尼/
Agostinucci	/阿戈斯蒂努奇/
Agosto	/阿戈斯托/
Agoston	/阿戈什顿/阿戈斯东/
Agostoni	/阿戈斯托尼/
Agostosi	/阿戈斯托西/
Agota	/阿戈塔/阿戈陶/
Agotai	/阿戈陶伊/
Agotay	/阿戈陶伊/
Agote	/阿戈特/
Agotha	/阿戈陶/
Agottani	/阿戈塔尼/
Agoudas	/阿古达/
Agoult	/阿古/
Agourram	/阿古拉姆/
Agout	/阿古/
Agov	/阿戈夫/
Agovic	/阿戈维奇/
Agovino	/阿戈维诺/
Agovski	/阿戈夫斯基/
Agoyan	/阿戈扬/
Agoye	/阿瓜耶/
Agozzino	/阿戈齐诺/
Agra	/阿格拉/
Agrachev	/阿格拉切夫/
Agradi	/阿格拉迪/
Agrafena	/阿格拉费娜/
Agrafenin	/阿格拉费宁/
Agrafenov	/阿格拉费诺夫/
Agrafonov	/阿格拉福诺夫/
Agrain	/阿格兰/
Agrainho	/阿格赖尼奥/
Agrait	/阿格赖特/
Agrali	/阿拉勒/
Agramon	/阿格拉蒙/
Agramonte	/阿格拉蒙特/
Agramunt	/阿格拉蒙特/
Agranat	/阿格拉纳/阿格拉纳特/
Agrander	/阿格兰德/
Agranenko	/阿格拉年科/
Agranov	/阿格拉诺夫/
Agranovic	/阿格拉诺维奇/
Agranovich	/阿格拉诺维奇/
Agranovski	/阿格拉诺夫斯基/
Agranovsky	/阿格拉诺夫斯基/
Agraria	/阿格拉里亚/
Agrario	/阿格拉里奥/
Agrasal	/阿格拉萨尔/
Agrasot	/阿格拉索特/
Agrati	/阿格拉蒂/
Agratina	/阿格拉蒂娜/
Agratinei	/阿格拉蒂内伊/
Agray	/阿格雷/
Agraz	/阿格拉斯/
Agrba	/阿格尔巴/
Agre	/阿格雷/
Agreda	/阿格雷达/
Agredaba	/阿格雷达瓦/
Agredana	/阿格雷达纳/
Agredano	/阿格雷达诺/
Agredeno	/阿格雷德尼奥/
Agregados	/阿格雷加多斯/
Agrela	/阿格雷拉/
Agrelas	/阿格雷拉斯/
Agrelin	/阿格雷林/
Agrell	/阿格雷尔/
Agrella	/阿格雷利亚/
Agrelli	/阿格雷利/
Agrelo	/阿格雷洛/
Agreman	/阿格雷曼/
Agren	/阿格伦/
Agrenev	/阿格列涅夫/
Agrenier	/阿格尔尼耶/
Agrenius	/阿格雷纽斯/
Agres	/阿格雷什/
Agresio	/阿格雷西奥/
Agresott	/阿格雷索特/
Agressi	/阿格雷西/
Agrest	/阿格雷斯特/
Agresta	/阿格雷斯塔/
Agreste	/阿格雷斯特/
Agresti	/阿格雷斯蒂/
Agresto	/阿格雷斯托/
Agrey	/阿格雷/
Agri	/阿格里/
Agria	/阿格里亚/
Agricola	/阿格里科拉/
Agricoli	/阿格里科利/
Agrien	/阿格连/
Agriffa	/阿格里法/
Agrifogli	/阿格里福利/
Agrifoglio	/阿格里福利奥/
Agriforni	/阿格里福尔尼/
Agrifoul	/阿格里富尔/
Agriga	/阿格里加/
Agrigento	/阿格里真托/
Agrigoroaei	/阿格里戈罗阿埃伊/
Agriian	/阿格里扬/
Agrikola	/阿格里科拉/
Agrikov	/阿格里科夫/
Agrilla	/阿格里利亚/
Agrillo	/阿格里洛/
Agrimi	/阿格里米/
Agrimont	/阿格里蒙/
Agrini	/阿格里尼/
Agrinier	/阿格里尼耶/
Agrinor	/阿格里诺尔/
Agrinski	/阿格林斯基/
Agrinsky	/阿格林斯基/
Agrip	/阿格里普/
Agripa	/阿格丽帕/
Agripina	/阿格里皮娜/
Agripino	/阿格里皮诺/
Agrippa	/阿格里帕/
Agrippich	/阿格里皮奇/
Agrippina	/阿格里平娜/
Agrippinetti	/阿格里皮内蒂/
Agrippino	/阿格里皮诺/
Agriri	/阿格里里/
Agrisano	/阿格里萨诺/
Agritmis	/阿勒特默什/
Agriturist	/阿格里图里斯特/
Agro	/阿格罗/
Agrocostea	/阿格罗科斯泰亚/
Agroferaz	/阿格罗费拉斯/
Agroff	/阿格罗夫/
Agrojardin	/阿格罗哈丁/
Agromayor	/阿格罗马约尔/
Agron	/阿格龙/
Agronick	/阿格罗尼克/
Agronik	/阿格罗尼克/
Agronomist	/阿格罗诺米斯特/
Agronov	/阿格罗诺夫/
Agronski	/阿格龙斯基/
Agronskin	/阿格龙斯金/
Agronsky	/阿格龙斯基/
Agroppi	/阿格罗皮/
Agrosi	/阿格罗西/
Agrosoaie	/阿格罗索阿耶/
Agroush	/阿杰鲁什/
Agrtz	/阿格茨/
Agruna	/阿格鲁尼亚/
Agry	/阿格里/
Agsjo	/阿格舍/
Agst	/阿格斯特/
Agstadius	/阿格斯塔迪乌斯/
Agsten	/阿格斯滕/
Agster	/阿格斯特尔/
Agt	/阿赫特/
Agtas	/阿塔什/
Agte	/阿格特/
Agu	/阿宫/阿乌/安久/安郡/
Agua	/阿古瓦/
Aguacel	/阿瓜塞尔/
Aguacil	/阿瓜西尔/
Aguad	/阿瓜德/
Aguade	/阿瓜德/
Aguadeiro	/阿瓜代罗/
Aguadero	/阿瓜德罗/
Aguado	/阿瓜多/
Aguados	/阿瓜多斯/
Aguagil	/阿瓜希尔/
Agualimpia	/阿瓜林皮亚/
Agualuza	/阿瓜卢萨/
Aguamell	/阿瓜梅利/
Aguanell	/阿瓜内利/
Aguanni	/阿关尼/
Aguanno	/阿关诺/
Aguar	/阿瓜尔/
Aguardela	/阿瓜尔德拉/
Aguardenteiro	/阿瓜尔登泰罗/
Aguardientes	/阿瓜迪恩特斯/
Aguareles	/阿瓜雷莱斯/
Aguaro	/阿瓜罗/
Aguarod	/阿瓜罗德/
Aguaron	/阿瓜龙/
Aguas	/阿瓜斯/
Aguayo	/阿瓜约/
Agucal	/阿古卡尔/
Agucalsa	/阿古卡尔萨/
Aguccini	/阿古奇尼/
Agud	/阿古德/
Aguda	/阿古达/
Agudelo	/阿古德洛/
Agudiez	/阿古迭斯/
Agudin	/阿古丁/
Agudinho	/阿古迪尼奥/
Agudo	/阿古多/
Ague	/埃格/
Agueci	/阿圭奇/
Agueda	/阿格达/
Aguedo	/阿格多/
Aguejas	/阿格哈斯/
Agueman	/阿格曼/
Aguene	/阿盖内/
Agueni	/阿格尼/
Aguenier	/阿格尼耶/
Aguer	/阿盖/
Aguera	/阿格拉/
Agueras	/阿格拉斯/
Aguero	/阿圭罗/
Agueros	/阿格罗斯/
Aguerral	/阿格拉尔/
Aguerralde	/阿格拉尔德/
Aguerre	/阿盖尔/
Aguerreberry	/阿盖尔贝里/
Aguerrevere	/阿格雷韦雷/
Aguerri	/阿格里/
Aguerrondo	/阿格龙多/
Aguesse	/阿盖斯/
Aguesseau	/阿盖索/
Aguet	/阿盖/
Aguetant	/阿盖唐/
Aguete	/阿格特/
Aguettand	/阿盖唐/
Aguettant	/阿盖唐/
Aguettaz	/阿盖塔/
Aguggiaro	/阿古贾罗/
Agugiaro	/阿古贾罗/
Aguglia	/阿古利亚/
Agugliati	/阿古利亚蒂/
Agui	/阿吉/阿食/安居/安居院/安食/日外/英比/英久比/
Aguia	/阿吉昂/阿吉亚/
Aguiah	/阿吉亚/
Aguiam	/阿吉安/
Aguiand	/阿吉昂/
Aguiano	/阿吉亚诺/
Aguiar	/阿吉亚尔/
Aguiari	/阿圭亚里/
Aguiati	/阿圭亚蒂/
Aguibou	/阿吉布/
Aguidazu	/阿吉达苏/
Aguie	/阿吉/
Aguieira	/阿吉埃拉/
Aguiella	/阿吉耶利亚/
Aguignier	/阿吉尼耶/
Aguiguah	/阿吉加/
Aguila	/阿吉拉/
Aguilaniedo	/阿吉拉涅多/
Aguilar	/阿吉拉尔/
Aguile	/阿吉勒/
Aguileira	/阿吉莱拉/
Aguilelca	/阿吉莱尔卡/
Aguilelia	/阿吉莱利亚/
Aguilella	/阿吉莱利亚/
Aguiler	/阿吉莱尔/
Aguilera	/阿吉莱拉/
Aguileta	/阿吉莱塔/
Aguililla	/阿吉利利亚/
Aguilino	/阿吉利诺/
Aguillaume	/阿吉廖梅/阿纪尧姆/
Aguillo	/阿吉略/
Aguillon	/阿吉永/
Aguillou	/阿吉尤/
Aguilo	/阿吉洛/
Aguilon	/阿吉隆/
Aguilucho	/阿吉卢乔/
Aguiluz	/阿吉卢斯/
Aguin	/安居院/
Aguinaco	/阿吉纳科/
Aguinaga	/阿吉纳加/
Aguinagalde	/阿吉纳加尔德/
Aguinalan	/阿吉纳兰/
Aguinaldo	/阿吉纳尔多/
Aguincha	/阿金沙/
Aguinet	/阿吉内/
Aguiniga	/阿吉尼加/
Aguino	/阿吉尼奥/
Aguinoa	/阿吉诺亚/
Aguion	/阿吉翁/
Aguir	/阿吉尔/
Aguiran	/阿吉兰/
Aguiregabiria	/阿吉雷加维里亚/
Aguiriano	/阿吉里亚诺/
Aguirrabengoa	/阿吉拉文戈亚/
Aguirre	/阿圭雷/阿吉雷/
Aguirrebana	/阿吉雷瓦尼亚/
Aguirreben	/阿吉雷文/
Aguirrebena	/阿吉雷韦尼亚/
Aguirrebengoa	/阿吉雷文戈亚/
Aguirregabiria	/阿吉雷加维里亚/
Aguirregaviria	/阿吉雷加维里亚/
Aguirregoitia	/阿吉雷戈伊蒂亚/
Aguirregomezcorta	/阿吉雷戈梅斯科塔/
Aguirregomoscorta	/阿吉雷戈莫斯科塔/
Aguirremota	/阿吉雷莫塔/
Aguirreurreta	/阿吉雷乌雷塔/
Aguirrezabal	/阿吉雷萨瓦尔/
Aguirrezabala	/阿吉雷萨瓦拉/
Aguirrezabalaga	/阿吉雷萨瓦拉加/
Aguirrizabal	/阿吉里萨瓦尔/
Aguiruz	/阿吉鲁斯/
Aguisan	/阿吉桑/
Aguiso	/阿吉索/
Aguiton	/阿吉东/
Aguiyi	/阿圭伊/
Aguizabal	/阿吉萨瓦尔/
Aguizor	/阿吉索尔/
Agujari	/阿吉亚里/
Agujas	/阿古哈斯/
Agujeta	/阿古赫塔/
Agujetas	/阿古赫塔斯/
Agular	/奥古拉尔/
Agulescu	/阿古列斯库/
Aguletii	/阿古莱蒂/
Aguletsi	/阿古列齐/
Aguletti	/阿古莱蒂/
Agulha	/阿古利亚/
Agulhas	/阿古利亚斯/
Agulheiro	/阿古列罗/
Agulhon	/阿居隆/
Agulini	/阿古利尼/
Agulla	/阿古利亚/阿居拉/
Agulleiro	/阿古列罗/
Agulli	/阿古利/
Agullo	/阿古略/
Agum	/阿古姆/
Agumaa	/阿古马/
Agumar	/阿古马尔/
Agumeh	/阿古梅/
Agumma	/阿古马/
Agumo	/阿昙/安昙/
Agun	/阿贡/阿金/
Aguna	/阿古尼亚/
Agundez	/阿贡德斯/
Agundo	/阿贡多/
Agune	/阿具根/英祢/
Agung	/阿贡/
Agunik	/阿古尼克/
Agunisa	/阿古尼萨/
Agura	/阿古拉/
Agurell	/阿古雷尔/
Aguren	/阿古伦/
Agureyev	/阿古列耶夫/
Aguri	/阿古里/阿久利/上里/上利/腾/余田/
Agurita	/阿古里察/
Aguro	/阿黑/安黑/
Agurrebena	/阿古雷韦尼亚/
Agurruza	/阿古鲁萨/
Agurto	/阿古尔托/
Aguru	/腾/
Agus	/阿古什/阿古斯/
Agusdin	/阿居斯丹/
Agusevic	/阿古舍维奇/
Agusi	/阿古希/
Agussol	/阿居索尔/
Agusta	/阿古斯塔/
Agusti	/阿古斯蒂/
Agustin	/阿古斯丁/
Agustina	/阿古斯蒂纳/
Agustinas	/阿古斯蒂纳斯/
Agustinho	/阿古斯蒂尼奥/
Agustino	/阿古斯蒂诺/
Agustinos	/阿古斯蒂诺斯/
Agustinus	/阿古斯蒂努斯/
Agusto	/阿古斯托/
Agustsson	/阿古斯特松/奥古斯特松/
Agut	/阿古特/阿居/
Aguta	/阿古塔/举田/
Aguttes	/阿居特/
Aguzumtsyan	/阿古祖姆强/
Agvald	/阿格瓦尔/阿格瓦尔德/
Agvaldsson	/阿格瓦尔德松/
Agvan	/阿格万/
Agvilla	/阿格维利亚/
Agwald	/阿格瓦尔德/
Agwu	/阿古武/
Agy	/阿吉/
Agyagasi	/奥焦加希/
Agyagfalvi	/奥焦格福尔维/
Agyare	/阿吉亚雷/
Agyekum	/阿吉耶库姆/
Agyeman	/阿杰曼/
Agyemfra	/阿格扬福拉/
Agyik	/阿吉克/
Agzam	/阿格扎姆/
Agzamkhodzhayev	/阿格扎姆霍贾耶夫/
Agzamov	/阿格扎莫夫/
Agziyagli	/阿泽亚勒/
Ah	/阿/亚/
Ahachi	/阿八/安八/
Ahacic	/阿哈契奇/
Ahad	/阿哈德/
Ahadi	/阿哈迪/
Ahadu	/阿哈杜/
Ahalt	/阿霍尔特/
Ahamada	/艾哈迈达/
Ahamadi	/艾哈迈迪/
Ahamane	/阿哈曼/
Ahamed	/艾哈迈德/
Ahamer	/阿哈默/
Ahanda	/阿汉达/
Ahani	/阿哈尼/
Ahanin	/阿哈宁/
Ahano	/阿波野/
Ahara	/阿原/
Ahardane	/阿哈达尼/
Ahari	/阿哈里/
Aharon	/阿哈龙/
Ahart	/阿哈特/
Aharu	/畔治/
Ahat	/阿哈特/
Ahaus	/阿豪斯/
Ahava	/阿哈瓦/
Ahaz	/阿哈兹/
Ahbel	/阿贝尔/
Ahciarliu	/阿赫恰尔柳/
Ahcin	/阿赫钦/
Ahdab	/阿赫达卜/
Ahde	/阿赫德/
Ahdekivi	/阿赫德基维/
Ahderinne	/阿赫德林内/
Ahdevaara	/阿赫德瓦拉/
Ahdrian	/阿德里安/
Ahe	/安拜/安闭/
Ahearn	/埃亨/
Ahearne	/阿亨/
Ahedo	/阿埃多/
Aheer	/阿希尔/
Ahel	/阿海尔/
Ahelmeyer	/阿赫尔迈尔/
Ahem	/阿赫姆/
Ahemm	/阿黑姆/
Ahenlle	/阿恩列/
Ahera	/阿海拉/
Aherghelegitei	/阿海盖莱吉采伊/
Aherh	/阿赫尔/
Aheri	/阿哈里/
Aherillo	/阿埃里略/
Aherma	/阿赫马/
Ahern	/阿埃伦/埃亨/
Aherne	/埃亨/
Aheron	/阿赫伦/
Aherren	/埃伦/
Aherva	/阿赫瓦/
Ahervuo	/阿赫沃/
Ahi	/阿赫/阿希/
Ahia	/阿希亚/
Ahianyo	/阿亚尼奥/
Ahiaz	/阿希亚兹/
Ahidjo	/阿希乔/
Ahijado	/阿伊哈多/
Ahijon	/阿伊洪/
Ahikali	/阿赫卡勒/
Ahikan	/阿赫坎/
Ahiko	/阿比古/阿彦/安彦/
Ahil	/阿希尔/阿伊尔/
Ahilagas	/阿伊拉加斯/
Ahile	/阿希莱/
Ahileas	/阿希莱亚斯/
Ahilo	/阿希洛/
Ahimeir	/阿希梅厄/
Ahimsa	/阿欣萨/
Ahin	/阿欣/
Ahino	/阿比野/
Ahipasaoglu	/阿赫帕夏奥卢/
Ahiru	/阿比留/安蒜/安昼/畔蒜/
Ahise	/阿伊塞/
Ahiska	/阿赫斯卡/
Ahiskalioglu	/阿赫斯卡勒奥卢/
Ahizoun	/阿希宗/
Ahizoune	/阿希宗/
Ahjo	/阿希奥/
Ahjokannas	/阿希奥卡纳斯/
Ahjokivi	/阿希奥基维/
Ahjokoski	/阿希奥科斯基/
Ahjolinna	/阿希奥林纳/
Ahjonen	/阿希奥宁/
Ahjoniemi	/阿希奥涅米/
Ahjonpalo	/阿希翁帕洛/
Ahjopalo	/阿希奥帕洛/
Ahjos	/阿希奥斯/
Ahl	/阿尔/
Ahla	/阿赫拉/
Ahlajarvi	/阿赫拉耶尔维/
Ahlajoki	/阿赫拉约基/
Ahlamaa	/阿赫拉马/
Ahland	/阿兰/
Ahlander	/阿兰德/
Ahlandsberg	/阿兰德斯贝里/
Ahlapuro	/阿赫拉普罗/
Ahlas	/阿洛斯/
Ahlavuo	/阿赫拉沃/
Ahlback	/阿尔巴克/阿尔贝克/
Ahlbaum	/阿尔鲍姆/
Ahlbeck	/阿尔贝克/
Ahlberg	/阿尔贝格/阿尔贝里/阿尔伯格/
Ahlberk	/阿尔贝克/
Ahlbert	/阿尔贝特/
Ahlbin	/阿尔宾/
Ahlblom	/阿尔布卢姆/
Ahlborg	/阿尔堡/
Ahlborn	/阿尔博恩/
Ahlbrandt	/阿尔布兰特/
Ahlbrecht	/阿尔布雷克特/阿尔布雷希特/
Ahlbrektsson	/阿尔布雷克特松/
Ahlburg	/阿尔堡/
Ahlby	/阿尔比/
Ahlden	/阿尔登/
Ahldin	/阿尔丁/
Ahle	/阿勒/
Ahleby	/阿勒比/
Ahlefeld	/阿勒费尔德/
Ahlefelder	/阿勒费尔德/
Ahlefeldt	/阿勒费尔特/
Ahlefelt	/阿勒费尔特/
Ahlefors	/阿勒福什/
Ahlehorn	/阿勒霍恩/
Ahlem	/阿勒姆/
Ahlemann	/阿勒曼/
Ahlemeyer	/阿勒迈尔/
Ahlen	/阿伦/
Ahlendorf	/阿伦多夫/
Ahlenhoff	/阿伦霍夫/
Ahlenius	/阿勒纽斯/
Ahlenstrand	/阿伦斯特兰德/
Ahlers	/阿勒斯/
Ahlert	/阿勒特/
Ahlerup	/阿勒鲁普/
Ahlevad	/阿勒瓦德/
Ahlex	/亚历克斯/
Ahlf	/阿尔夫/
Ahlfanger	/阿尔芬格/
Ahlfeld	/阿尔费尔德/
Ahlfeldt	/阿尔费尔特/
Ahlfont	/阿尔丰特/
Ahlford	/阿尔福德/
Ahlforn	/阿尔福恩/
Ahlfors	/阿尔福什/阿尔福斯/
Ahlfvengren	/阿尔文格伦/
Ahlgreen	/阿尔格伦/
Ahlgren	/阿尔格伦/
Ahlgrimm	/阿尔格里姆/
Ahlholm	/阿尔霍尔姆/
Ahlijah	/阿赫利贾/
Ahlin	/阿赫林/阿林/
Ahlinder	/阿林德/
Ahling	/阿林/
Ahlingtoft	/阿林托夫特/
Ahliny	/阿利尼/
Ahlklo	/阿尔克洛/
Ahlkvist	/阿尔奎斯特/
Ahlm	/阿尔姆/
Ahlman	/阿尔曼/
Ahlmark	/阿尔马克/
Ahlmen	/阿尔门/
Ahlmer	/阿尔默/
Ahlnander	/阿尔南德/
Ahlnas	/阿尔奈斯/
Ahlnefors	/阿尔内福什/
Ahlner	/阿尔纳/
Ahlnorn	/阿尔诺恩/
Ahlport	/阿尔波特/
Ahlquist	/阿尔奎斯特/
Ahlqvist	/阿尔奎斯特/
Ahlrichs	/阿尔里希斯/
Ahlroos	/阿尔罗斯/
Ahlros	/阿尔罗斯/
Ahlrot	/阿尔罗特/
Ahls	/阿尔斯/
Ahlschwede	/阿尔施韦德/
Ahlsell	/阿尔塞尔/
Ahlsen	/阿尔森/
Ahlsien	/阿尔辛/
Ahlsing	/阿尔辛/
Ahlsjo	/阿尔舍/
Ahlskog	/阿尔斯科格/
Ahlsmo	/阿尔斯莫/
Ahlson	/阿尔松/
Ahlsson	/阿尔松/
Ahlstam	/阿尔斯坦/
Ahlstedt	/阿尔斯泰特/
Ahlstrand	/阿尔斯特兰德/
Ahlstrom	/阿尔斯特伦/
Ahlsved	/阿尔斯韦德/
Ahlswede	/阿尔斯韦德/
Ahlten	/阿尔滕/
Ahltin	/阿尔廷/
Ahltorp	/阿尔托普/
Ahltsen	/阿尔森/
Ahlund	/阿隆德/奥隆德/
Ahluwalia	/阿卢瓦利亚/
Ahlvarn	/阿尔韦恩/
Ahlvarsson	/阿尔瓦松/
Ahlvers	/阿尔费斯/
Ahlvik	/阿尔维克/
Ahlvin	/阿尔温/
Ahlving	/阿尔温/
Ahlwardt	/阿尔瓦特/
Ahlzen	/阿尔森/
Ahm	/阿姆/
Ahma	/阿赫马/
Ahmad	/艾哈迈德/艾买提/
Ahmadan	/阿赫马丹/
Ahmadezadeh	/艾哈迈德－扎德/
Ahmadi	/艾哈迈迪/
Ahmadie	/艾哈迈迪耶/
Ahmadin	/艾哈迈丁/
Ahmadou	/艾哈迈杜/
Ahmady	/艾哈迈迪/
Ahmadzai	/艾哈德迈扎伊/
Ahmajarvi	/阿赫马耶尔维/
Ahmala	/阿赫马拉/
Ahman	/阿曼/
Ahmanache	/阿马纳什/
Ahmanheimo	/阿赫曼海莫/
Ahmann	/阿曼/
Ahmanson	/阿曼森/
Ahmaoja	/阿赫毛亚/
Ahmar	/阿赫马尔/
Ahmarani	/阿赫马拉尼/
Ahmarova	/阿赫马罗瓦/
Ahmas	/阿赫马斯/
Ahmat	/艾哈迈德/
Ahmavaara	/阿赫马瓦拉/
Ahmed	/艾哈迈德/
Ahmedali	/艾哈迈德－阿里/
Ahmedally	/艾哈迈德－阿里/
Ahmeddin	/艾哈迈德丁/
Ahmedi	/艾哈迈迪/
Ahmedou	/艾哈迈杜/
Ahmedov	/艾哈迈多夫/
Ahmedovic	/艾哈迈多维奇/
Ahmeen	/阿梅恩/
Ahmer	/阿赫马尔/
Ahmet	/艾哈迈德/
Ahmetagic	/艾哈迈塔吉奇/
Ahmeti	/艾哈迈迪/
Ahmetoglu	/艾哈迈德奥卢/
Ahmetovic	/艾哈迈托维奇/
Ahmilon	/阿米隆/
Ahmoud	/艾哈迈德/
Ahn	/阿恩/安/
Ahnache	/阿纳什/
Ahnberg	/安贝里/翁贝里/
Ahnborg	/安堡/
Ahnborn	/安博恩/
Ahne	/阿赫内/
Ahnefeld	/阿内费尔德/
Ahnegard	/阿内高/
Ahnell	/阿内尔/
Ahnelov	/阿内勒夫/
Ahnelt	/埃内尔特/
Ahnemark	/阿内马克/
Ahnen	/阿嫩/
Ahner	/阿纳/
Ahnert	/阿纳特/
Ahnfalk	/安法尔克/
Ahnfeldt	/安费尔特/
Ahnfelt	/安费尔特/
Ahnhem	/安赫姆/
Ahnighito	/阿尼吉托/
Ahnild	/阿尼尔德/
Ahnland	/安兰/
Ahnlo	/安洛/
Ahnlund	/安隆德/
Ahnmark	/安马克/
Ahnmarker	/安马克/
Ahnme	/安梅/
Ahnova	/阿赫诺娃/
Ahnquist	/安奎斯特/
Ahnroth	/安罗特/
Ahnsjo	/安舍/
Ahnsteen	/安斯滕/
Ahnstrand	/安斯特兰德/
Ahnstrom	/安斯特伦/
Ahntholz	/阿恩索尔兹/
Ahnve	/安弗/
Ahnwall	/安瓦尔/
Aho	/阿保/阿霍/安保/神/英保/
Ahoinpelto	/阿霍因佩尔托/
Ahokainen	/阿霍凯宁/
Ahokangas	/阿霍坎加斯/
Ahokanto	/阿霍坎托/
Ahokas	/阿霍卡斯/
Ahokoski	/阿霍科斯基/
Ahola	/阿霍拉/
Aholahti	/阿霍拉赫蒂/
Aholainen	/阿霍莱宁/
Aholin	/阿霍林/
Ahomaa	/阿霍马/
Ahomaki	/阿霍迈基/
Ahonen	/阿霍宁/
Ahoneva	/阿霍内瓦/
Ahoniemi	/阿霍涅米/
Ahonius	/阿霍纽斯/
Ahonlinna	/阿洪林纳/
Ahonoja	/阿霍诺亚/
Ahonvala	/阿洪瓦拉/
Ahopalo	/阿霍帕洛/
Ahopelto	/阿霍佩尔托/
Ahoranta	/阿霍兰塔/
Ahorinta	/阿霍林塔/
Ahorro	/阿奥罗/
Ahos	/阿霍斯/
Ahosilta	/阿霍西尔塔/
Ahosola	/阿霍索拉/
Ahotupa	/阿霍图帕/
Ahoua	/阿胡瓦/
Ahovaara	/阿霍瓦拉/
Ahovuori	/阿霍沃里/
Ahponen	/阿赫波宁/
Ahr	/阿尔/
Ahranit	/阿赫拉尼特/
Ahras	/阿拉斯/
Ahrberg	/阿尔贝里/
Ahrbjorn	/阿尔比约恩/
Ahrbom	/阿尔布姆/
Ahrborg	/阿尔堡/
Ahrdenberg	/阿登贝里/
Ahre	/阿赫雷/
Ahreback	/阿雷巴克/阿雷贝克/
Ahreberg	/阿雷贝里/
Ahrebo	/阿雷博/
Ahremaa	/阿赫雷马/
Ahremark	/阿雷马克/
Ahren	/阿伦/
Ahrenbeck	/阿伦贝克/
Ahrenberg	/阿伦贝里/
Ahrenbjork	/阿伦比约克/
Ahrenbrandt	/阿伦布兰特/
Ahrenby	/阿伦比/
Ahrend	/阿伦德/
Ahrends	/阿伦茨/
Ahrendt	/阿伦特/
Ahrengart	/阿伦加特/
Ahrenholtz	/阿伦霍尔茨/
Ahrenkiel	/阿伦基尔/
Ahrenling	/阿伦林/
Ahrenmark	/阿伦马克/
Ahrens	/阿伦斯/
Ahrensdort	/阿伦斯多特/
Ahrensfeld	/阿伦斯菲尔德/
Ahrenskou	/阿伦斯科/
Ahrenstedt	/阿伦斯泰特/
Ahrent	/阿伦特/
Ahrenthal	/埃伦塔尔/
Ahresten	/阿雷斯滕/
Ahretlik	/阿赫雷特利克/
Ahrfeldt	/阿费尔特/
Ahrfelt	/阿费尔特/
Ahrgren	/阿尔格伦/
Ahriche	/阿里什/
Ahringer	/阿林格/
Ahrland	/阿尔兰/
Ahrle	/阿尔勒/阿勒/
Ahrlestrom	/阿勒斯特伦/
Ahrlind	/阿林德/
Ahrling	/阿林/
Ahrlo	/阿洛/
Ahrmfeldt	/阿姆费尔特/
Ahrnberg	/阿恩贝里/
Ahrnbom	/阿恩布姆/
Ahrnborg	/阿恩堡/
Ahrndsen	/阿恩德森/
Ahrne	/阿尔内/
Ahrneberg	/阿尔内贝里/
Ahrnell	/阿内尔/
Ahrnes	/阿尔内斯/
Ahrnewald	/阿内瓦尔德/
Ahrnfeldt	/阿恩费尔特/
Ahrnfelt	/阿恩费尔特/
Ahrnhoff	/阿恩霍夫/
Ahrnsbrak	/阿恩斯布拉克/
Ahrnstedt	/阿恩斯泰特/
Ahroon	/阿鲁恩/
Ahrsjo	/阿尔舍/
Ahru	/阿赫鲁/
Ahrweiler	/阿尔魏勒/
Ahsan	/阿赫桑/
Ahsanuddin	/阿赫桑丁/
Ahsanul	/阿赫桑/
Ahsbahs	/阿斯巴斯/奥赫什鲍赫什/
Ahsendorf	/阿森多夫/
Ahsp	/阿斯普/
Ahssan	/阿赫桑/
Ahston	/阿斯顿/
Ahstrand	/奥斯特兰德/
Ahtaja	/阿赫塔亚/
Ahte	/阿赫特/
Ahteela	/阿赫泰拉/
Ahteensuu	/阿赫滕苏/
Ahtela	/阿赫泰拉/
Ahti	/阿赫蒂/
Ahtiainen	/阿赫蒂艾宁/
Ahtiala	/阿赫蒂亚拉/
Ahtik	/阿赫蒂克/
Ahtikari	/阿赫蒂卡里/
Ahtikivi	/阿赫蒂基维/
Ahtila	/阿赫蒂拉/
Ahtiluoto	/阿赫蒂洛托/
Ahtinen	/阿赫蒂宁/
Ahtisaari	/阿赫蒂萨里/
Ahto	/阿赫托/
Ahtokari	/阿赫托卡里/
Ahtola	/阿赫托拉/
Ahtomaa	/阿赫托马/
Ahtonen	/阿赫托宁/
Ahtovirta	/阿赫托维尔塔/
Ahuad	/阿瓦德/
Ahuarghub	/阿赫瓦尔古卜/
Ahues	/阿韦斯/
Ahuja	/阿胡贾/阿胡亚/阿乌哈/
Ahujetas	/阿乌赫塔斯/
Ahumada	/阿乌马达/
Ahumados	/阿乌马多斯/
Ahvala	/阿赫瓦拉/
Ahven	/阿赫文/
Ahvenainen	/阿赫韦奈宁/
Ahvenjarvi	/阿赫文耶尔维/
Ahvenlahti	/阿赫文拉赫蒂/
Ahvenlampi	/阿赫文兰皮/
Ahvenniemi	/阿赫文涅米/
Ahvenoja	/阿赫韦诺亚/
Ahvenus	/阿赫韦努斯/
Ahvo	/阿赫沃/
Ahvonen	/阿赫沃宁/
Ahwache	/阿赫瓦什/
Ahwal	/阿赫瓦勒/
Ahwas	/阿赫瓦什/
Ahwe	/阿韦/
Ahwij	/阿赫维杰/
Ahwoi	/阿赫沃伊/
Ahxner	/阿克斯纳/
Ahyo	/安/
Ahyub	/阿尤布/
Ahzene	/阿赫齐尼/
Ai	/阿井/阿位/埃/蔼/艾/碍/爱/隘/安居/安威/安慰/蓝/四十/相/崖/涯/捱/嫒/暧/
Aiah	/阿亚/
Aiaiz	/艾阿伊斯/
Aiartyan	/艾阿尔强/
Aiastan	/艾阿斯坦/
Aiau	/相合/
Aiba	/艾巴/爱场/饱庭/合场/合叶/合羽/会场/蓝场/秋庭/染叶/相场/相马/相庭/相叶/相羽/飨场/飨庭/
Aibar	/艾瓦尔/
Aibara	/合原/蓝原/蓬原/粟饭原/相原/
Aibart	/艾瓦尔特/
Aibe	/爱部/相部/
Aibek	/艾别克/
Aibeo	/艾贝奥/
Aibibi	/艾比比/
Aiblinger	/艾布林格/
Aibner	/艾布纳/
Aibuchi	/相渊/
Aicard	/艾卡尔/
Aicardi	/艾卡尔迪/
Aicart	/艾卡特/
Aich	/艾希/
Aicha	/艾莎/艾沙/
Aichatou	/艾沙图/
Aichberger	/艾克贝里耶/艾希贝格尔/
Aichbichler	/艾希比希勒/
Aiche	/艾沙/
Aichelburg	/艾赫尔堡/艾歇尔堡/
Aichele	/艾凯莱/艾切莱/艾歇勒/
Aichelin	/艾歇林/
Aichelmann	/艾赫尔曼/
Aichen	/艾兴/
Aicher	/艾克/艾歇尔/
Aichholz	/艾希霍尔茨/
Aichhorn	/艾克霍恩/
Aichi	/爱发/爱知/爱智/相知/
Aichikawa	/爱智河/
Aichiku	/爱竹/
Aichinger	/艾兴格尔/
Aichingerova	/艾兴格罗娃/
Aichingr	/艾兴格尔/
Aichler	/艾赫莱尔/
Aichmann	/艾希曼/
Aichmayr	/艾希迈尔/
Aichroth	/艾克罗思/
Aiciondo	/艾西翁多/
Aick	/艾克/
Aicoboaiei	/艾科博阿耶伊/
Aicua	/艾库瓦/
Aid	/艾德/
Aida	/阿以田/艾达/合田/会田/间/间田/蓝田/蓬田/相田/英田/
Aidah	/艾达/
Aidala	/艾达拉/
Aidam	/艾达姆/
Aidamirov	/艾达米罗夫/
Aidan	/艾当/
Aidano	/间野/
Aidar	/艾达尔/
Aidara	/艾达拉/
Aidarbek	/艾达尔别克/
Aidarbekov	/艾达尔别科夫/
Aidarov	/艾达罗夫/
Aidas	/艾达斯/
Aidbyn	/奥依德布/
Aide	/阿伊德/艾德/
Aideed	/艾迪德/
Aidehag	/艾德哈格/
Aideheim	/艾德海姆/
Aideira	/艾代拉/
Aidelberg	/艾德尔贝格/
Aidelsburger	/艾德尔斯布格/
Aidenoff	/艾德诺夫/
Aiderfors	/艾德福什/
Aidi	/艾迪/
Aidid	/艾迪德/
Aidimireanu	/艾迪米雷亚努/
Aidinbek	/艾金别克/
Aidinbekov	/艾金别科夫/
Aidinov	/艾季诺夫/
Aidinyan	/艾季尼扬/
Aidit	/艾地/
Aido	/艾多/
Aidogaz	/艾多加/
Aidoo	/艾杜/
Aidos	/艾多斯/
Aidoud	/艾杜/
Aidraliyev	/艾德拉利耶夫/
Aidrous	/艾德鲁斯/
Aidyn	/艾登/
Aidyngaliyev	/艾登加利耶夫/
Aidzhamal	/艾贾马尔/
Aiello	/阿耶洛/艾埃洛/艾洛/
Aiesh	/艾什/
Aifal	/艾法尔/
Aifesa	/艾费萨/
Aiftincai	/艾夫廷克伊/
Aiga	/埃雅/安乎/合贺/秋贺/相贺/
Aigars	/艾加尔斯/
Aigasa	/相笠/
Aigasha	/艾加莎/
Aigen	/艾根/
Aigengruber	/艾根格鲁贝尔/
Aigetsu	/爱月/
Aigle	/艾格莱/艾格勒/
Aigler	/艾格勒/
Aiglin	/艾格兰/
Aiglon	/艾格隆/
Aignan	/艾尼昂/
Aignaux	/艾尼奥/
Aigner	/艾格纳/
Aignerova	/艾格内罗娃/
Aigo	/爱吾/
Aigoin	/艾古安/
Aigon	/艾贡/
Aigoro	/爱吾郎/爱吾卢/
Aigouy	/艾古伊/
Aigrain	/艾格兰/
Aigre	/艾格尔/
Aigrefeuille	/艾格勒弗耶/
Aigremont	/艾格勒蒙/
Aigret	/艾格雷/
Aigreville	/艾格勒维尔/
Aigron	/艾格龙/
Aigrot	/艾格罗/
Aiguabella	/艾瓜韦利亚/
Aigub	/艾古布/
Aiguchi	/相口/
Aiguier	/艾吉耶/
Aiguille	/艾吉耶/
Aiguilles	/艾吉耶/
Aiguillon	/艾吉永/
Aigul	/艾古利/
Aigun	/艾贡/
Aiguy	/艾居伊/
Aiha	/相羽/
Aihala	/艾哈拉/
Aihara	/合原/蓝原/蓬原/相原/
Aiharu	/爱春/
Aihashi	/相桥/
Aihide	/爱英/
Aihiko	/爱彦/
Aihisa	/爱久/爱寿/
Aihito	/爱仁/
Aiho	/艾霍/
Aihonen	/艾霍宁/
Aihoshi	/会星/
Aii	/相井/
Aiichi	/爱一/
Aiichiro	/爱一郎/
Aiim	/艾伊姆/
Aiiso	/相矶/
Aija	/艾亚/
Aijala	/埃伊耶莱/
Aijalainen	/埃伊耶莱宁/
Aijanaho	/埃伊耶纳霍/
Aijanen	/埃伊耶宁/
Aiji	/爱次/爱尔/爱二/爱治/
Aijima	/相岛/
Aijiro	/爱次郎/爱二郎/爱治郎/
Aijitsuro	/爱日楼/
Aijmer	/艾默/
Aijo	/埃伊约/
Aijon	/艾洪/
Aiju	/爱十/
Aijuro	/爱十郎/
Aik	/额/厄/掖/腋/液/益/奕/
Aika	/会贺/秋鹿/粟鹿/
Aikaa	/埃伊凯/
Aikachant	/亿甲仓/
Aikala	/艾卡拉/
Aikami	/合上/会上/相神/
Aikas	/埃伊凯斯/
Aikasalo	/艾卡萨洛/
Aikawa	/爱川/淡川/淡河/逢川/合川/会川/蓝川/四十川/相川/相河/鲇川/
Aikaz	/艾卡兹/
Aikazyan	/艾卡江/
Aikei	/爱敬/
Aiken	/艾肯/
Aikens	/艾肯斯/
Aikhenvald	/艾亨瓦尔德/
Aiki	/爱纪/爱树/爱岐/合木/相木/
Aikia	/埃伊基埃/
Aikibe	/网部/
Aikichi	/蔼吉/爱吉/
Aikichiro	/爱吉郎/
Aikin	/艾金/
Aikins	/艾金斯/
Aikio	/艾基奥/
Aikioniemi	/艾基奥涅米/
Aikitsu	/爱橘/
Aikkila	/艾基拉/
Aikman	/艾克曼/
Aiko	/爱甲/爱子/蓝子/相子/亚以子/
Aikoku	/爱国/
Aikomo	/艾科莫/
Aikov	/艾科夫/
Aiku	/爱久/
Aikul	/艾库尔/
Aikuni	/艾库尼/
Aikura	/相仓/
Aikush	/艾库什/
Aikyo	/爱敬/蓝香/相京/
Aila	/艾拉/
Ailam	/艾朗/
Ailamo	/艾拉莫/
Ailas	/艾拉斯/
Aileen	/艾琳/
Aileleri	/艾莱莱里/
Ailena	/艾莱娜/
Ailenei	/艾莱内伊/
Aileni	/艾莱尼/
Ailer	/艾勒/
Ailes	/艾尔斯/
Ailesbury	/艾尔斯伯里/
Ailhaud	/阿约/
Ailhet	/阿耶/
Aili	/艾利/
Ailice	/艾利斯/
Ailiesei	/艾列塞伊/
Ailinca	/艾林卡/
Ailincai	/艾林克伊/
Ailio	/艾利奥/
Ailioaie	/艾利瓦耶/
Ailiyav	/艾力耶甫/
Aillard	/阿亚尔/
Aillaud	/阿约/
Ailleau	/阿约/
Ailleret	/阿耶雷/
Aillerie	/阿耶里/
Aillet	/阿耶/
Aillier	/阿耶/
Aillieres	/阿耶尔/
Ailliot	/阿约/
Aillod	/阿约/
Aillon	/阿永/
Aillot	/阿约/
Ailloud	/阿尤/
Ailly	/阿伊/
Ailm	/艾尔姆/
Ailsa	/艾尔萨/
Ailshie	/艾尔希/
Ailus	/艾卢斯/
Ailwyn	/艾尔温/艾尔文/
Aim	/艾姆/
Aima	/爱马/合间/
Aimable	/艾马布勒/
Aimadieu	/艾马迪厄/
Aimala	/埃伊梅莱/
Aimamedov	/艾马梅多夫/
Aiman	/四十万/
Aimanov	/艾马诺夫/
Aimants	/艾芒/
Aimar	/艾马尔/
Aimard	/艾马尔/
Aimaru	/爱丸/
Aimasa	/爱正/爱政/
Aimatsu	/爱松/
Aimbetov	/艾姆别托夫/
Aime	/艾梅/
Aimedieu	/艾默迪厄/
Aimee	/艾梅/
Aimel	/艾梅尔/
Aimelafille	/艾默拉菲耶/
Aimeric	/艾默里克/
Aimery	/艾默里/
Aimetti	/艾梅蒂/
Aimez	/艾梅/
Aimi	/会见/明海/相见/
Aimichi	/爱道/
Aimin	/艾曼/
Aimini	/艾米尼/
Aimio	/艾米奥/
Aimitsu	/爱光/
Aimiya	/相宫/
Aimmerman	/艾默尔曼/
Aimmsa	/艾姆萨/
Aimo	/艾莫/
Aimoin	/艾穆安/
Aimola	/艾莫拉/
Aimon	/艾蒙/
Aimonaho	/艾莫纳霍/
Aimond	/艾蒙/
Aimonen	/艾莫宁/
Aimonino	/艾莫尼诺/
Aimono	/四十物/五十物语/
Aimori	/会森/
Aimot	/艾莫/
Aimoto	/会本/相本/
Aimova	/艾莫娃/
Aimsa	/艾姆萨/
Aimu	/爱巳/相武/
Aimura	/会村/
Aimurzaev	/艾穆尔扎耶夫/
Aimurzayev	/艾穆尔扎耶夫/
Ain	/艾恩/艾因/
Aina	/艾娜/艾纳/
Ainabekov	/艾纳别科夫/
Ainaga	/艾纳加/爱长/
Ainai	/相内/
Ainaka	/爱仲/
Ainala	/艾纳拉/
Ainalov	/艾纳洛夫/
Ainamo	/艾纳莫/
Ainanshe	/艾南希/
Ainao	/爱直/
Ainard	/艾纳尔/
Ainardi	/艾纳尔迪/
Ainari	/合成/
Ainars	/艾纳尔斯/
Ainasoja	/艾纳索亚/
Ainasto	/艾纳斯托/
Aincoa	/艾因科亚/
Aine	/艾内/相根/
Aineau	/艾诺/
Ainerud	/艾内鲁德/
Aines	/安斯/
Ainetdin	/艾内丁/
Aineto	/艾内托/
Aing	/英/樱/莺/撄/
Ainger	/安杰/
Ainhorn	/艾因霍恩/
Aini	/艾尼/
Ainini	/艾尼尼/
Ainley	/艾因利/安利/
Ainman	/安曼/
Ainmiller	/艾因米勒/
Ainnab	/艾纳卜/
Aino	/艾诺/爱野/间野/蓝野/始罪/相野/
Ainobu	/爱信/爱宣/
Ainokata	/爱方/
Ainoki	/会退/
Ainokuchi	/相野口/
Ainola	/艾诺拉/
Ainori	/爱教/
Ainoseki	/相关/
Ainosuke	/爱之辅/爱之介/爱之佑/爱之助/
Ainoura	/相浦/
Ainova	/艾诺娃/
Ainoyama	/合山/会山/间山/
Ainoza	/艾诺萨/
Ainsa	/艾因萨/
Ainsar	/艾因萨尔/
Ainscough	/安斯克夫/
Ainse	/艾因塞/
Ainsi	/艾因西/
Ainsley	/安斯利/
Ainslie	/艾因斯列/安斯利/
Ainsworth	/安斯沃思/
Aintila	/艾因蒂拉/
Aintrazi	/艾因特拉齐/
Ainval	/安瓦尔/
Ainver	/艾因弗/
Ainz	/艾因斯/
Ainzaft	/艾恩扎夫特/
Aio	/爱夫/爱男/
Aioanei	/艾瓦内伊/
Aioi	/相生/
Aiomi	/爱臣/
Aiosa	/阿约萨/
Aipli	/艾普利/
Aira	/艾拉/爱罗/蛤良/始良/相良/
Airado	/艾拉多/
Airaksinen	/艾拉克西宁/
Airamaa	/艾拉马/
Airamo	/艾拉莫/
Airapetian	/艾拉佩强/
Airapetov	/艾拉佩托夫/
Airapetyan	/艾拉佩强/
Airapetyants	/艾拉佩强茨/
Airas	/艾拉斯/
Airasca	/艾拉斯卡/
Airaskorpi	/艾拉斯科皮/
Airasmaa	/艾拉斯马/
Airasvirta	/艾拉斯维尔塔/
Airasvuo	/艾拉斯沃/
Airaud	/艾罗/
Airault	/艾罗/
Airaut	/艾罗/
Aircin	/艾尔钦/
Aird	/艾尔德/
Aire	/艾雷/
Aireault	/艾罗/
Airedale	/艾尔代尔/
Airedin	/艾雷丁/
Airell	/艾雷尔/
Aires	/艾雷斯/
Airesto	/艾雷斯托/
Airey	/艾雷/
Airhart	/艾尔哈特/
Airi	/艾里/相李/
Airiau	/艾里奥/
Airiev	/艾里耶夫/
Airikainen	/艾里凯宁/
Airikka	/艾里卡/
Airikkala	/艾里卡拉/
Airila	/艾里拉/
Airimo	/艾里莫/
Airinei	/艾里内伊/
Airinen	/艾里宁/
Airio	/艾里奥/
Airis	/艾里斯/
Airisto	/艾里斯托/
Airiyan	/艾里扬/
Airizer	/艾里策/
Airlie	/艾尔利/
Airo	/艾罗/爱郎/
Airoaiei	/艾罗阿耶伊/
Airola	/艾罗拉/
Airolo	/艾罗洛/
Airos	/艾罗斯/
Airosmaa	/艾罗斯马/
Airoso	/艾罗索/
Airosto	/艾罗斯托/
Airto	/艾尔托/
Airton	/艾尔顿/
Airue	/艾吕/
Airumyan	/艾鲁米扬/
Airusalo	/艾鲁萨洛/
Airvault	/艾尔沃/
Airwick	/艾尔威克/
Airy	/艾里/
Airyan	/艾良/
Ais	/艾斯/
Aisa	/艾萨/爱佐/相佐/
Aisagali	/艾萨加利/
Aisagaly	/艾萨加利/
Aisaka	/逢阪/逢坂/相坂/
Aisaki	/合崎/相崎/
Aisaku	/爱策/爱作/
Aisami	/埃萨米/
Aisamo	/艾萨莫/
Aisara	/艾萨拉/
Aisari	/相去/
Aisato	/爱乡/
Aisawa	/爱泽/逢泽/合泽/会泽/蓝泽/相泽/
Aisei	/爱成/
Aiseki	/蔼夕/爱石/
Aisen	/爱染/
Aisengart	/艾森加特/
Aisenjevova	/艾塞涅沃娃/
Aish	/阿什/艾什/
Aisha	/艾萨/艾莎/
Aishah	/艾萨/
Aishakhan	/艾沙汉/
Aishalton	/艾沙尔顿/
Aishat	/艾沙特/
Aishe	/艾萨/艾莎/
Aisheikh	/艾谢赫/
Aishi	/爱志/爱子/
Aishichi	/爱七/
Aishichiro	/爱七郎/
Aishige	/爱成/爱茂/爱重/
Aishima	/相岛/
Aishin	/爱亲/
Aishiro	/爱志郎/相城/
Aishisi	/艾希西/
Aishoji	/爱松寺/
Aishton	/艾什顿/
Aishwarya	/艾什瓦尔雅/
Aisiain	/艾西亚因/
Aisin	/艾辛/
Aisingiorro	/爱新觉罗/
Aislam	/艾斯拉姆/
Aisley	/艾斯利/
Aisman	/艾什曼/
Aismann	/艾什曼/
Aismanova	/艾什曼诺娃/
Aisne	/艾纳/
Aiso	/爱曾/爱祖/相宗/相矶/
Aisogawa	/合曾川/会曾川/
Aisoka	/哀草果/
Aisoltan	/艾索尔坦/
Aisome	/爱染/蓝染/
Aisonsalo	/艾松萨洛/
Aisopos	/伊索/
Aispurua	/艾斯普鲁亚/
Aiss	/艾斯/
Aissa	/艾萨/伊萨/
Aissadou	/艾萨杜/
Aissah	/艾萨/
Aissamy	/埃萨米/
Aissani	/艾萨尼/
Aissaoui	/艾萨维/
Aissat	/艾萨特/
Aissata	/艾萨塔/艾莎塔/
Aissatou	/艾萨图/
Aistleitner	/艾斯特莱特纳/
Aistola	/艾斯托拉/
Aistov	/艾斯托夫/
Aistulf	/艾斯图尔夫/
Aisu	/爱须/爱洲/会洲/
Aisuke	/爱辅/爱介/爱佑/爱助/
Aisumi	/四十住/相墨/
Ait	/艾特/
Aita	/阿以田/艾塔/爱多/爱太/爱田/合田/会田/蓝田/明田/莫太/莫田/蓬田/秋田/相田/英多/英田/
Aitada	/爱忠/
Aitagi	/爱多义/
Aitaka	/爱孝/
Aitake	/相武/
Aitakov	/艾塔科夫/
Aitala	/艾塔拉/
Aitalampi	/艾塔兰皮/
Aitamaoui	/艾塔马维/
Aitamer	/艾塔梅/
Aitamurto	/艾塔穆尔托/
Aitan	/艾坦/
Aitana	/艾塔纳/
Aitani	/合谷/会谷/相谷/
Aitaro	/爱多郎/爱太郎/
Aitasalo	/艾塔萨洛/
Aitawal	/艾塔瓦尔/
Aitbayev	/艾特巴耶夫/
Aitcheson	/艾奇逊/
Aitchison	/艾奇逊/
Aiteanu	/艾泰亚努/
Aitel	/艾特尔/
Aitelli	/艾泰利/
Aitenfisu	/艾滕菲苏/
Aitero	/艾泰罗/
Aitferhat	/艾特弗拉/
Aithamon	/艾塔蒙/
Aithamy	/埃萨米/
Aithani	/艾萨尼/
Aitia	/艾蒂亚/
Aitidir	/艾蒂迪尔/
Aitiev	/艾季耶夫/
Aitimova	/艾季莫娃/
Aitio	/艾蒂奥/
Aitiyev	/艾季耶夫/
Aitjarvi	/艾特耶尔维/
Aitken	/艾特肯/
Aitkenhead	/艾特肯黑德/
Aitkin	/艾特金/
Aitkoski	/艾特科斯基/
Aitkul	/艾特库尔/
Aitkuluyev	/艾特库卢耶夫/
Aitman	/艾特曼/
Aitmanov	/艾特马诺夫/
Aitmat	/艾特马特/
Aitmatov	/艾特马托夫/
Aitmuratov	/艾特穆拉托夫/
Aito	/艾托/
Aitoff	/艾托夫/
Aitok	/艾托克/
Aitokallio	/艾托卡利奥/
Aitokari	/艾托卡里/
Aitoki	/爱时/
Aitoku	/爱德/相德/
Aitokugawa	/爱德川/
Aitola	/艾托拉/
Aitolahti	/艾托拉赫蒂/
Aitomo	/爱知/
Aiton	/艾顿/
Aitona	/艾托纳/
Aitoniemi	/艾托涅米/
Aitosalo	/艾托萨洛/
Aitoshi	/爱俊/爱敏/
Aitouali	/艾图阿利/
Aitouares	/艾图阿雷/
Aitour	/艾图尔/
Aitov	/艾托夫/
Aitpai	/艾特帕伊/
Aitpay	/艾特帕伊/
Aitpayev	/艾特帕耶夫/
Aitre	/艾特尔/
Aitsam	/艾察姆/
Aitsu	/合津/相津/
Aitsuchi	/合土/
Aitsuka	/明冢/
Aitsuki	/相/
Aitta	/艾塔/
Aittakallio	/艾塔卡利奥/
Aittakorpi	/艾塔科皮/
Aittamaa	/艾塔马/
Aittamaki	/艾塔迈基/
Aittamo	/艾塔莫/
Aittanen	/艾塔宁/
Aittasalmi	/艾塔萨尔米/
Aittasalo	/艾塔萨洛/
Aitter	/艾特/
Aitto	/艾托/
Aittojoki	/艾托约基/
Aittokoski	/艾托科斯基/
Aittola	/艾托拉/
Aittolampi	/艾托兰皮/
Aittomaki	/艾托迈基/
Aittoniemi	/艾托涅米/
Aittovaara	/艾托瓦拉/
Aituarov	/艾图阿罗夫/
Aitui	/艾图伊/
Aitykin	/艾特金/
Aitym	/艾特姆/
Aitymbetov	/艾特姆别托夫/
Aitzaz	/艾察兹/
Aitzetmuller	/艾策特米勒/
Aiuchi	/相内/
Aiura	/蓝浦/相浦/
Aiusheev	/阿尤舍耶夫/
Aivado	/艾瓦多/
Aivalioti	/艾瓦廖蒂/
Aivancesei	/艾文切塞伊/
Aivanen	/艾瓦宁/
Aivar	/艾瓦尔/
Aivars	/艾瓦尔斯/
Aivarzian	/艾瓦尔济安/
Aivas	/艾瓦/艾瓦斯/
Aivashvili	/艾瓦什维利/
Aivatzisz	/艾沃齐斯/
Aivaz	/艾瓦/艾瓦兹/
Aivazian	/艾瓦江/
Aivazov	/艾瓦佐夫/
Aivazovski	/艾瓦佐夫斯基/
Aivazovsky	/艾瓦佐夫斯基/
Aivazyan	/艾瓦江/
Aivert	/艾韦特/
Aivila	/艾维拉/
Aiwaka	/爱若/
Aix	/艾克斯/
Aixala	/艾克萨拉/
Aixinger	/艾克辛格/
Aixner	/艾克斯纳/
Aiya	/艾娅/爱谷/爱屋/爱也/蓝谷/
Aiyama	/合山/间山/相山/
Aiyar	/艾亚尔/
Aiye	/艾耶/
Aiyoshi	/爱嘉/爱善/爱义/相吉/
Aiyu	/爱雄/
Aiyuki	/爱幸/爱之/
Aiza	/艾萨/
Aizaburo	/爱三郎/
Aizac	/艾扎克/
Aizaki	/合崎/相崎/
Aizan	/爱山/
Aizarani	/艾扎拉尼/
Aizatulin	/艾扎图林/
Aizawa	/爱泽/逢泽/合泽/会泽/蓝泽/相泽/
Aizcorbe	/艾斯科韦/
Aizeki	/相关/
Aizen	/艾曾/爱染/
Aizenberg	/艾森贝格/
Aizenman	/艾森曼/
Aizenshtadt	/艾森施塔特/
Aizenshtein	/艾森施泰因/
Aizenstat	/艾森斯塔特/
Aizer	/艾泽尔/
Aizerman	/艾泽曼/
Aizertin	/艾泽尔坦/
Aizeurrutia	/艾塞乌鲁蒂亚/
Aizic	/艾齐克/
Aizier	/艾齐耶/
Aizieres	/艾齐埃/
Aizieu	/艾齐厄/
Aizin	/艾津/
Aizinfrati	/艾津弗拉蒂/
Aizman	/艾兹曼/
Aizner	/艾兹内/
Aizo	/爱藏/爱三/爱象/
Aizome	/逢初/
Aizouibel	/艾索伊韦尔/
Aizpeurrutia	/艾斯佩乌鲁蒂亚/
Aizpiri	/艾斯皮里/艾兹皮里/
Aizpu	/艾斯普/
Aizpun	/艾斯蓬/
Aizpuno	/艾斯普诺/
Aizpuro	/艾斯普罗/
Aizpuru	/艾斯普鲁/
Aizpurua	/艾斯普鲁亚/
Aizpuzua	/艾斯普苏亚/
Aizquaray	/艾斯夸赖/
Aizquibel	/艾斯基韦尔/
Aizsilnieks	/艾西尔尼克斯/
Aizsiniek	/艾西尼耶克/
Aizu	/爱洲/会津/会洲/
Aizumi	/爱澄/爱纯/
Aizuya	/会津屋/
Aja	/阿哈/阿贾/
Ajab	/阿贾卜/
Ajaccienne	/阿雅西耶娜/
Ajadaa	/阿雅达/
Ajadil	/阿雅迪尔/
Ajah	/阿贾/
Ajahji	/阿贾吉/
Ajaiora	/阿哈约拉/
Ajaj	/阿贾杰/
Ajakainen	/阿亚凯宁/
Ajala	/阿贾拉/
Ajalbert	/阿雅尔贝/
Ajalin	/阿亚林/
Ajalmar	/阿雅尔马/
Ajaltouni	/阿贾勒图尼/
Ajam	/阿贾姆/阿让/
Ajami	/阿贾米/
Ajamil	/阿哈米尔/
Ajamo	/阿亚莫/
Ajanidisz	/奥尧尼迪斯/
Ajanki	/阿扬基/
Ajanovic	/阿亚诺维奇/
Ajanti	/阿扬蒂/
Ajanto	/阿扬托/
Ajape	/阿雅佩/
Ajarnaute	/阿哈瑙特/
Ajas	/阿雅/
Ajasse	/阿雅斯/
Ajaste	/阿亚斯特/
Ajat	/阿贾特/
Ajataritei	/阿扎塔里采伊/
Ajates	/阿哈特斯/
Ajatovic	/阿亚托维奇/
Ajavon	/阿雅冯/
Ajawi	/阿贾维/
Ajax	/阿雅克斯/阿亚克斯/埃贾克斯/
Ajaxon	/阿亚克松/
Ajaxson	/阿亚克松/
Ajay	/阿贾伊/
Ajayi	/阿贾伊/阿雅伊/
Ajazi	/阿贾齐/
Ajazo	/奥尧佐/
Ajben	/阿伊本/
Ajcevic	/艾切维奇/
Ajdacic	/艾达契奇/
Ajdan	/艾丹/
Ajdana	/艾达娜/
Ajdanic	/艾达尼奇/
Ajdanovic	/艾达诺维奇/
Ajdar	/艾达尔/
Ajdarevic	/艾达雷维奇/
Ajdari	/艾达里/
Ajdaric	/艾达里奇/
Ajdarov	/艾达罗夫/
Ajdarovic	/艾达罗维奇/
Ajder	/艾德尔/
Ajdert	/艾德特/
Ajdic	/艾迪奇/
Ajdin	/艾丁/
Ajdini	/艾迪尼/
Ajdinovic	/艾迪诺维奇/
Ajdovnik	/艾多夫尼克/
Ajdukiewicz	/艾杜凯维奇/
Ajdukovic	/艾杜科维奇/
Ajdzanovic	/艾扎诺维奇/
Ajea	/阿赫亚/
Ajean	/阿让/
Ajeel	/阿吉勒/
Ajejas	/阿赫哈斯/
Ajelli	/阿耶利/
Ajello	/阿耶洛/
Ajemian	/阿杰米恩/
Ajena	/阿热娜/
Ajenjo	/阿亨霍/
Ajenjos	/阿亨霍斯/
Ajer	/阿热/
Ajero	/阿赫罗/
Ajerste	/阿热斯特/
Ajet	/阿耶特/
Ajeti	/阿耶蒂/
Ajetovic	/阿耶托维奇/
Ajhir	/阿杰希尔/
Aji	/阿字/按司/味/庵治/
Ajia	/阿吉亚/亚细亚/
Ajibade	/阿吉巴德/
Ajibe	/味部/
Ajibola	/阿吉博拉/
Ajiboye	/阿吉博耶/
Ajichi	/阿知知/味知/
Ajiga	/安路贺/
Ajika	/阿直/安直/
Ajikai	/阿字戒/
Ajikata	/味方/味形/
Ajikawa	/阿治川/庵治川/
Ajiki	/阿直/阿直岐/阿志岐/安/安饰/安直/安敕城/味木/
Ajikichi	/亚次吉/
Ajikino	/安食野/
Ajiku	/阿吉库/
Ajikubo	/味洼/
Ajima	/安岛/味间/味真/
Ajimi	/安心院/
Ajimu	/阿昙/安心院/
Ajimura	/味村/
Ajina	/阿吉纳/
Ajini	/阿吉尼/
Ajinki	/安/
Ajino	/味野/
Ajinowa	/味野和/
Ajioka	/东父冈/味冈/
Ajip	/阿伊普/
Ajiro	/网代/足代/
Ajisa	/味佐/
Ajisawa	/味泽/
Ajishi	/味志/
Ajit	/阿吉特/
Ajita	/味田/
Ajitani	/味谷/
Ajitarita	/阿日塔里察/
Ajitha	/阿吉塔/
Ajito	/网户/味户/
Ajiwa	/味和/
Ajiyama	/味山/
Ajjaka	/阿贾卡/
Ajjan	/阿让/
Ajjaz	/阿贾兹/
Ajjoub	/阿朱卜/
Ajjouri	/阿朱里/
Ajkai	/奥伊考伊/
Ajkalo	/艾卡洛/
Ajkavolgyi	/奥伊考沃尔吉/
Ajkay	/奥伊考伊/
Ajkija	/艾基亚/
Ajkler	/奥伊克勒/
Ajkuna	/艾库娜/
Ajlani	/阿杰拉尼/
Ajler	/奥伊勒/
Ajli	/阿伊利/
Ajlouni	/阿杰卢尼/
Ajlouny	/阿杰卢尼/
Ajluni	/阿杰卢尼/
Ajm	/艾姆/
Ajmal	/阿杰马勒/
Ajmani	/阿杰马尼/
Ajmeri	/阿杰梅里/
Ajmi	/阿贾米/
Ajmut	/艾穆特/
Ajnas	/阿杰纳斯/
Ajne	/艾内/
Ajnefelt	/艾内费尔特/
Ajnefors	/艾内福什/
Ajneling	/艾内林/
Ajnesjo	/艾内舍/
Ajnestahl	/艾内斯托尔/
Ajnevall	/艾内瓦尔/
Ajnik	/艾尼克/
Ajnspiler	/艾因施皮勒/
Ajo	/阿霍/阿约/
Ajodhya	/阿霍迪亚/
Ajomaa	/阿约马/
Ajon	/阿容/
Ajoret	/阿若雷/
Ajosa	/阿约萨/
Ajose	/阿乔塞/
Ajou	/阿茹/阿朱/
Ajour	/阿茹尔/阿朱尔/
Ajoux	/阿茹/
Ajouz	/阿朱兹/
Ajoy	/阿乔伊/
Ajram	/阿杰拉姆/
Ajrauacif	/艾劳阿契夫/
Ajroski	/艾罗斯基/
Ajrovic	/艾罗维奇/
Ajrulovski	/艾鲁洛夫斯基/
Ajsenbajser	/艾森拜塞尔/
Ajtai	/奥伊陶伊/
Ajtay	/奥伊陶伊/
Ajtic	/艾蒂奇/
Ajtony	/奥伊托尼/
Ajtonyi	/奥伊托尼/
Aju	/阿茹/
Ajubita	/阿胡维塔/
Ajuda	/阿茹达/
Ajun	/阿容/
Ajunwa	/阿均瓦/
Ajupi	/阿尤皮/
Ajuria	/阿胡里亚/
Ajvaz	/艾瓦兹/
Ajvazovic	/艾瓦佐维奇/
Ajzenbajser	/艾森拜塞尔/
Ajzenhamer	/艾森哈梅尔/
Ajzenkol	/艾森科尔/
Ajzenkolb	/艾森科尔布/
Ajzert	/奥伊泽尔特/
Ajzinberg	/艾津贝格/
Ak	/阿/阿克/乐/握/岳/渥/鳄/
Ak-Kys	/阿克斯/
Aka	/阿嘉/阿卡/安贺/赤/丹/英贺/胝/
Akaad	/阿卡德/
Akaan	/阿坎/
Akaana	/赤穴/
Akaba	/赤场/赤羽/
Akabane	/赤刨/赤羽/赤羽根/赤羽祢/赤刎/赤埴/
Akabani	/赤埴/
Akabashi	/赤桥/
Akabay	/阿卡巴伊/
Akabayashi	/赤林/
Akabe	/赤部/
Akabey	/阿卡贝伊/
Akabori	/赤堀/
Akaboshi	/赤星/明星/
Akabotsu	/赤穗津/
Akachi	/赤池/赤地/
Akacin	/阿卡琴/
Akacs	/奥卡奇/
Akacsos	/奥卡乔什/
Akad	/阿卡德/
Akada	/阿伽陀/赤田/铜田/朱田/绯田/
Akadate	/赤馆/
Akadateyama	/赤馆山/
Akadigbo	/阿卡迪博/
Akadli	/阿卡德勒/
Akadomari	/赤泊/
Akae	/赤江/赤兄/赤枝/红江/
Akaebashi	/赤江桥/
Akaeda	/赤枝/
Akaei	/赤永/
Akaeze	/阿凯泽/
Akafomo	/阿卡福莫/
Akafuchi	/赤渊/
Akagaki	/赤垣/
Akagami	/赤上/赤神/
Akagane	/赤金/赤铜/铜/
Akagari	/赤雁/耀/胝/
Akagawa	/赤川/赤河/
Akagi	/阿卡吉/赤城/赤木/具木/明城/明木/
Akagire	/胝/
Akagiri	/赤桐/
Akagishi	/赤岸/
Akagunduz	/阿卡金迪兹/
Akahagi	/赤刎/
Akahane	/赤羽/
Akahani	/赤土/赤埴/
Akahashi	/赤桥/
Akahi	/赤日/
Akahiko	/赤孙/赤彦/
Akahira	/赤平/
Akahiro	/赤广/
Akaho	/赤穗/
Akahoko	/赤/
Akahori	/赤堀/
Akahoshi	/赤星/
Akai	/阿凯/赤井/阏加井/阏伽井/
Akaibo	/赤井坊/阏伽井坊/
Akaike	/赤池/
Akaiko	/赤猪子/
Akaileh	/阿凯拉/
Akaishi	/赤石/
Akaishisawa	/赤石泽/
Akaiwa	/赤岩/
Akaji	/赤地/赤路/
Akajima	/赤岛/
Akajiro	/赤城/
Akajirushi	/赤符/
Akaka	/阿卡卡/
Akakabe	/赤壁/明壁/
Akakawa	/赤川/赤河/
Akaki	/阿卡基/赤木/
Akakias	/阿卡基亚斯/
Akakije	/阿卡基耶/
Akakiyev	/阿卡基耶夫/
Akakpo	/阿卡波/
Akakpovie	/阿卡波维/
Akakubo	/赤久保/
Akakuma	/赤熊/
Akakura	/赤仓/
Akaky	/阿卡基/
Akal	/阿卡尔/
Akala	/阿卡拉/
Akalan	/阿卡兰/
Akalar	/阿卡拉尔/
Akalay	/阿卡莱/
Akale	/阿卡勒/
Akali	/阿卡勒/
Akalin	/阿卡伦/
Akalinoglu	/阿卡伦奥卢/
Akalla	/阿卡拉/
Akalovsky	/阿卡洛夫斯基/
Akalp	/阿卡尔普/
Akaltan	/阿卡尔坦/
Akaltin	/阿卡尔滕/
Akaltun	/阿卡尔通/
Akam	/阿卡姆/
Akama	/赤间/赤马/赤磨/赤万/朱间/
Akamae	/赤前/
Akamaro	/阿可麻吕/赤麻吕/
Akamataki	/赤间泷/
Akamatsu	/赤松/
Akame	/阿卡梅/赤目/
Akami	/赤见/明见/
Akamine	/赤峰/赤岭/明峰/
Akamisaka	/赤见坂/
Akamoto	/赤本/
Akamura	/赤村/
Akan	/阿坎/
Akana	/赤名/赤穴/
Akanabe	/赤锅/茜部/
Akanaga	/赤永/
Akanashi	/杜/杠/
Akanay	/阿卡纳伊/
Akanbi	/阿坎比/
Akande	/阿坎德/
Akander	/阿坎德/
Akane	/赤根/赤岭/赤祢/茜/
Akanebe	/茜部/
Akanegakubo	/茜久保/
Akaner	/阿卡内尔/
Akaneya	/茜屋/
Akangni	/阿康尼/
Akannac	/阿坎纳奇/
Akano	/赤野/
Akanoto	/赤塔/
Akanovic	/阿卡诺维奇/
Akansel	/阿坎塞尔/
Akanson	/阿坎松/
Akansu	/阿坎苏/
Akant	/阿坎特/
Akantisz	/奥孔蒂斯/
Akanu	/阿卡努/
Akanuma	/阿鹿沼/赤沼/
Akanyidiz	/阿坎耶德兹/
Akao	/赤生/赤穗/赤尾/
Akaochi	/赤祖父/
Akaogi	/赤荻/
Akaoglu	/阿卡奥卢/
Akaoji	/赤祖父/
Akaoka	/赤冈/
Akaoke	/赤桶/
Akaosawa	/赤尾泽/
Akaoseki	/赤尾关/
Akaotsu	/赤尾津/
Akaoui	/阿卡维/
Akapekabou	/阿卡佩卡布/
Akar	/阿卡尔/奥考尔/
Akarat	/奥考劳特/
Akaray	/阿卡拉伊/
Akarca	/阿卡尔贾/
Akarcay	/阿卡尔恰伊/
Akari	/明理/明里/明利/亚厂/亚里/亚历/
Akarin	/阿卡伦/
Akarmagan	/阿卡尔马甘/
Akarsan	/阿卡尔桑/
Akarsu	/阿卡尔苏/
Akartuna	/阿卡尔图纳/
Akarturk	/阿卡蒂尔克/
Akaru	/赤留/耀/
Akarun	/阿卡伦/
Akary	/阿卡里/
Akasa	/阿卡萨/赤佐/
Akasaka	/赤阪/赤坂/
Akasaki	/赤崎/
Akasane	/赤真/
Akasawa	/赤泽/
Akase	/赤亩/赤濑/明濑/
Akasegawa	/赤濑川/
Akashi	/赤石/赤司/赤自/丹/明石/
Akashiba	/赤柴/赤芝/
Akashida	/明石田/
Akashige	/赤繁/
Akashika	/赤鹿/
Akashiki	/赤敷/
Akashima	/赤岛/
Akashinoama	/明石海/
Akashinoamabe	/明石海部/
Akashio	/赤盐/
Akashiro	/赤城/
Akashisawa	/赤石泽/
Akashita	/丹下/
Akashiya	/明石屋/
Akasofu	/赤祖父/
Akasome	/赤染/赤染部/垢染/
Akasot	/阿卡索特/
Akasoy	/阿卡索伊/
Akassou	/阿卡苏/
Akasu	/赤须/
Akat	/阿卡特/
Akata	/阿方/阿卡塔/阿片/阿形/赤田/明田/有方/
Akatani	/赤谷/
Akataro	/赤太郎/
Akatate	/赤馆/
Akatay	/阿卡塔伊/
Akateru	/丹照/
Akatli	/阿卡特勒/
Akato	/赤塔/赤藤/
Akatori	/赤鸟/
Akatov	/阿卡托夫/
Akatsu	/赤津/
Akatsuchi	/赤土/
Akatsui	/赤对/
Akatsuka	/赤柄/赤冢/晓霞/
Akatsukasa	/赤司/
Akatsuki	/晓/
Akatsuru	/赤鹤/
Akaturk	/阿卡蒂尔克/
Akaune	/赤亩/赤浦/
Akauola	/阿考奥拉/
Akavov	/阿卡沃夫/
Akawa	/阿川/溃河/吾川/
Akawayama	/吾川山/
Akawilou	/阿卡维卢/
Akay	/阿卡伊/奥考伊/
Akayama	/赤山/
Akayaz	/阿卡亚兹/
Akaydin	/阿卡伊登/
Akayemov	/阿卡耶莫夫/
Akayev	/阿卡耶夫/
Akayevich	/阿卡耶维奇/
Akayin	/阿卡延/
Akayleh	/阿凯利赫/
Akayli	/阿卡伊勒/
Akaza	/赤坐/赤座/朱座/
Akazaan	/藜庵/
Akazaki	/赤崎/
Akazawa	/赤泽/
Akaze	/赤亩/
Akazeev	/阿卡泽耶夫/
Akazome	/赤染/赤染部/垢染/
Akazomebe	/赤染部/
Akazuka	/赤冢/
Akazuru	/赤鹤/
Akba	/阿克巴/
Akbaba	/阿克巴巴/
Akbacakoglu	/阿克巴贾克奥卢/
Akbahar	/阿克巴哈尔/
Akbaicilar	/阿克巴厄哲拉尔/
Akbal	/阿克巴尔/
Akbali	/阿克巴利/
Akbalik	/阿克巴勒克/
Akban	/阿克班/
Akbar	/阿克巴尔/阿克瓦尔/
Akbaran	/阿克巴兰/
Akbari	/阿克巴里/
Akbarnejad	/阿克巴尔内贾德/
Akbarov	/阿克巴罗夫/
Akbarut	/阿克巴鲁特/
Akbas	/阿克巴什/
Akbasak	/阿克巴沙克/
Akbasan	/阿克巴桑/
Akbasli	/阿克巴什勒/
Akbat	/阿克巴特/
Akbatu	/阿克巴图/
Akbatur	/阿克巴图尔/
Akbay	/阿克巴伊/
Akbayar	/阿克巴亚尔/
Akbayrak	/阿克巴伊拉克/
Akbaytugan	/阿克巴伊图甘/
Akbeg	/阿克贝/
Akbek	/阿克贝克/
Akbel	/阿克贝尔/
Akber	/阿克别尔/
Akberdiyev	/阿克别尔季耶夫/
Akbi	/阿克比/
Akbil	/阿克比尔/
Akbilge	/阿克比尔盖/
Akbiyik	/阿克伯耶克/
Akbiyikoglu	/阿克伯耶克奥卢/
Akboga	/阿克博阿/
Akbora	/阿克博拉/
Akboru	/阿克伯吕/
Akbov	/阿克博夫/
Akbudak	/阿克布达克/
Akbudun	/阿克布敦/
Akbug	/阿克布/
Akbulut	/阿克布卢特/
Akburak	/阿克布拉克/
Akburc	/阿克布尔奇/
Akca	/阿克贾/阿克恰/
Akcabay	/阿克恰巴伊/
Akcaboy	/阿克恰博伊/
Akcadurak	/阿克恰杜拉克/
Akcael	/阿克恰埃尔/
Akcag	/阿克恰/
Akcaglar	/阿克恰拉尔/
Akcaglilar	/阿克恰勒拉尔/
Akcaharman	/阿克恰哈尔曼/
Akcail	/阿克恰厄尔/
Akcakan	/阿克恰坎/
Akcakanad	/阿克恰卡纳德/
Akcakanat	/阿克恰卡纳特/
Akcakaya	/阿克恰卡亚/
Akcakayalioglu	/阿克恰卡亚勒奥卢/
Akcakin	/阿克恰肯/
Akcakoca	/阿克恰科贾/
Akcal	/阿克恰尔/
Akcali	/阿克恰勒/
Akcalioglu	/阿克恰勒奥卢/
Akcam	/阿卡姆/阿克恰姆/
Akcan	/阿克灿/阿克詹/
Akcaoglu	/阿克恰奥卢/
Akcar	/阿克恰尔/
Akcasu	/阿克恰苏/
Akcay	/阿克恰伊/
Akcebe	/阿克杰贝/
Akcengiz	/阿克坚吉兹/
Akcer	/阿克切尔/
Akcevin	/阿克切温/
Akchar	/阿克沙尔/
Akchir	/阿克希尔/
Akchote	/阿克绍泰/
Akchurin	/阿克丘林/
Akciger	/阿克吉埃尔/
Akcigir	/阿克彻厄尔/
Akcinar	/阿克彻纳尔/
Akcinlioglu	/阿克琴勒奥卢/
Akcit	/阿克彻特/
Akciz	/阿克彻兹/
Akcoglu	/阿克奇奥卢/
Akcor	/阿克乔尔/
Akcora	/阿克乔拉/
Akcoraoglu	/阿克乔拉奥卢/
Akcura	/阿克丘拉/
Akdag	/阿克达/阿克达格/
Akdal	/阿克达尔/
Akdamar	/阿克达马尔/
Akdas	/阿克达什/
Akde	/阿克德/
Akdede	/阿克代德/
Akdemir	/阿克代米尔/
Akdeniz	/阿克代尼兹/
Akdere	/阿克代雷/
Akdevekioglu	/阿克代韦基奥卢/
Akdik	/阿克迪克/
Akdiken	/阿克迪肯/
Akdog	/阿克多/
Akdogan	/阿克多安/
Akdoganli	/阿克多安勒/
Akdogdu	/阿克多杜/
Akdogmus	/阿克多穆什/
Akdogu	/阿克多乌/
Akdol	/阿克德尔/
Akdora	/阿克多拉/
Akdoru	/阿克多鲁/
Akdoruk	/阿克多鲁克/
Akduman	/阿克杜曼/
Akdur	/阿克杜尔/
Akduran	/阿克杜兰/
Akdurmus	/阿克杜尔穆什/
Akdzhigitov	/阿克吉吉托夫/
Ake	/阿克/阿气/安家/奥克/日外/耀/朱/
Akearashi	/明岚/
Akebayashi	/明林/
Akebi	/明比/明日/
Akebono	/晓/
Akechi	/明地/明知/明智/
Aked	/埃克德/
Akeda	/耕田/明田/
Akedo	/明渡/明户/
Akegarasu	/晓乌/
Akegi	/具木/明城/明木/
Akeguchi	/明口/
Akehi	/明比/明日/
Akehira	/明平/
Akeho	/明穗/
Akei	/明日/
Akeishi	/明石/
Akeji	/明路/
Akel	/阿克尔/阿克勒/
Akele	/阿凯莱/
Akelevich	/阿克列维奇/
Akeley	/埃克利/
Akema	/阿克马/
Akemaru	/明丸/
Akematsu	/明松/
Akemi	/东见/明见/明美/曙览/晓美/
Akemine	/明峰/
Akemoto	/明本/
Akemura	/明村/
Aken	/阿肯/
Akena	/阿凯纳/
Akenande	/阿克南德/
Akendengue	/阿肯登盖/
Akengin	/阿肯金/
Akenhead	/埃肯黑德/
Akeno	/明野/晓/晓野/
Akenside	/埃肯赛德/
Akenti	/阿肯季/
Akenty	/阿肯季/
Akenuma	/明沼/
Akenzua	/阿肯祖阿/
Akeo	/旦尾/晓雄/
Akepsi	/阿克普西/
Akepsim	/阿克普西姆/
Akepsy	/阿克普西/
Aker	/阿凯尔/阿克/
Akera	/具乐/来乐/明/明乐/明浦/明荣/雅乐/朱乐/
Akerblom	/阿克布卢姆/
Akerdem	/阿凯尔代姆/
Akeren	/阿克伦/
Akergin	/阿凯尔因/
Akerl	/奥凯尔/
Akerlund	/阿克尔隆德/
Akermalm	/奥克马尔姆/
Akerman	/阿凯尔曼/阿克曼/奥克曼/
Akermann	/阿克曼/
Akers	/埃克斯/
Akersan	/阿凯尔桑/
Akersin	/阿凯尔辛/
Akerson	/埃克森/
Akersoy	/阿凯尔索伊/
Akerstedt	/奥克斯泰特/
Akerstrom	/阿克斯特伦/
Akerta	/阿克塔/
Akerud	/阿克鲁德/
Akesaka	/明坂/
Akesson	/奥克松/
Aketa	/举田/明田/朱田/
Aketo	/明渡/
Akewa	/明和/
Akewaka	/明若/
Akeyama	/明山/
Akezhan	/阿克然/
Akezuki	/明月/
Akezuma	/明妻/
Akgayev	/阿克加耶夫/
Akgemci	/阿克盖姆吉/
Akgenc	/阿克根奇/
Akgerman	/阿克盖尔曼/
Akgiray	/阿克吉拉伊/
Akgol	/阿克格尔/
Akgonul	/阿克格尼尔/
Akgor	/阿克格尔/
Akgoz	/阿克格兹/
Akgoze	/阿克格泽/
Akguc	/阿克居奇/
Akgul	/阿克居尔/
Akgumus	/阿克居米什/
Akgun	/阿克金/
Akgunay	/阿克居纳伊/
Akgunduz	/阿克金迪兹/
Akguner	/阿克居内尔/
Akgunes	/阿克居内什/
Akgungor	/阿克金格尔/
Akgunler	/阿克金莱尔/
Akgur	/阿克居尔/
Akgurbuz	/阿克居尔比兹/
Akgure	/阿克古勒/
Akhadov	/阿哈多夫/
Akhaik	/阿海克/
Akhal	/阿哈尔/阿哈勒/
Akhaladze	/阿哈拉泽/
Akhaltsev	/阿哈利采夫/
Akham	/阿哈姆/
Akhan	/阿汉/阿坎/阿克汗/
Akhanov	/阿哈诺夫/
Akhaoui	/阿哈维/
Akhapkin	/阿哈普金/
Akhari	/阿哈里/
Akhat	/阿哈特/
Akhavan	/阿哈万/
Akhavni	/阿哈夫妮/
Akhavnik	/阿哈夫尼克/
Akhbar	/阿赫巴尔/
Akhdar	/阿赫达尔/
Akhdi	/阿赫季/
Akher	/阿海尔/
Akhiezer	/阿希耶泽尔/
Akhigbe	/阿基贝/
Akhikyan	/阿希基扬/
Akhil	/阿希尔/
Akhila	/阿希拉/
Akhill	/阿希尔/
Akhilli	/阿希利/
Akhilly	/阿希利/
Akhilo	/阿希洛/
Akhinszky	/奥金斯基/
Akhinyan	/阿希尼扬/
Akhiya	/阿希亚/
Akhizhanov	/阿希扎诺夫/
Akhkadyan	/阿赫卡江/
Akhlaghi	/阿克拉吉/
Akhlaq	/阿赫拉克/
Akhlebin	/阿赫列宾/
Akhmad	/艾哈迈德/
Akhmadaliyev	/艾哈迈达利耶夫/
Akhmadiyev	/艾哈迈迪耶夫/
Akhmadov	/艾哈迈多夫/
Akhmadulin	/艾哈迈杜林/
Akhmadulina	/艾哈迈杜林娜/
Akhmadzhan	/艾哈迈占/
Akhmanov	/阿赫马诺夫/
Akhmarov	/阿赫马罗夫/
Akhmatbek	/艾哈迈德别克/
Akhmatov	/艾哈迈托夫/
Akhmatova	/艾哈迈托娃/
Akhmed	/艾哈迈德/
Akhmedkhan	/艾哈迈德汗/
Akhmedov	/艾哈迈多夫/
Akhmedovich	/艾哈迈多维奇/
Akhmedzhan	/艾哈迈占/
Akhmedzhanov	/艾哈迈贾诺夫/
Akhmedzhanovich	/艾哈迈贾诺维奇/
Akhmedzyanov	/艾哈迈贾诺夫/
Akhmerov	/阿赫梅罗夫/
Akhmet	/艾哈迈德/
Akhmeteli	/艾哈迈捷利/
Akhmetkaliyev	/艾哈迈德卡利耶夫/
Akhmetov	/艾哈迈托夫/
Akhmetovich	/艾哈迈托维奇/
Akhmetshin	/艾哈迈德申/
Akhmetukov	/艾哈迈图科夫/
Akhmetyev	/艾哈迈季耶夫/
Akhmetzhan	/艾哈迈德然/
Akhmetzhanov	/艾哈迈德扎诺夫/
Akhnazarov	/阿赫纳扎罗夫/
Akhobadze	/阿霍巴泽/
Akhokhov	/阿霍霍夫/
Akhond	/阿洪德/
Akhonin	/阿霍宁/
Akhonzadeh	/阿洪扎德/
Akhospireli	/阿霍斯皮列利/
Akhpashev	/阿赫帕舍夫/
Akhrameyev	/阿赫拉梅耶夫/
Akhramovich	/阿赫拉莫维奇/
Akhranit	/阿赫拉尼特/
Akhras	/阿赫拉斯/
Akhremenkov	/阿赫列缅科夫/
Akhriyev	/阿赫里耶夫/
Akhromenko	/阿赫罗缅科/
Akhsarbek	/阿赫萨尔别克/
Akhsharumov	/阿赫沙鲁莫夫/
Akhtal	/阿赫塔勒/
Akhtanov	/阿赫塔诺夫/
Akhtar	/阿赫塔尔/
Akhtari	/阿赫塔里/
Akhtaruddin	/阿赫塔尔丁/
Akhtarul	/阿赫塔尔/
Akhtarzand	/阿克塔尔桑德/
Akhter	/阿克特尔/
Akhtyamov	/阿赫佳莫夫/
Akhtyrski	/阿赫特尔斯基/
Akhtyrsky	/阿赫特尔斯基/
Akhumian	/阿胡米扬/
Akhumov	/阿胡莫夫/
Akhumyan	/阿胡米扬/
Akhun	/阿洪/阿克洪/
Akhunbabayev	/阿洪巴巴耶夫/
Akhunbayev	/阿洪巴耶夫/
Akhund	/阿洪德/
Akhundi	/阿洪迪/
Akhundov	/阿洪多夫/
Akhundzhanov	/阿洪扎诺夫/
Akhunov	/阿胡诺夫/
Akhunovich	/阿胡诺维奇/
Akhurst	/阿克赫斯特/
Akhutin	/阿胡京/
Akhvedy	/阿赫韦德/
Akhverdiyev	/阿赫韦尔季耶夫/
Akhverdov	/阿赫韦尔多夫/
Akhverdyan	/阿赫韦尔江/
Akhvledian	/阿赫夫列季安/
Akhvlediani	/阿赫夫列季阿尼/
Akhyar	/阿赫亚尔/
Akhymbekov	/阿亨别科夫/
Aki	/阿贵/阿基/阿记/阿纪/阿克/阿木/阿树/阿岐/安城/安发/安癸/安吉/安来/安木/安喜/安艺/安岐/聪/秋/耀/
Akia	/阿基亚/
Akiala	/阿基亚拉/
Akialp	/阿克阿尔普/
Akian	/阿基昂/
Akias	/阿基亚/
Akiatsu	/秋笃/章笃/彰笃/昭笃/
Akiba	/阿基巴/秋场/秋马/秋庭/秋叶/响庭/
Akibe	/汉部/秋部/
Akibo-Betts	/阿基博－贝茨/
Akica	/阿基察/
Akichi	/秋地/秋知/
Akichika	/明亲/秋亲/章近/章亲/彰近/彰亲/昭近/昭亲/
Akici	/阿克哲/
Akida	/阿基达/
Akidil	/阿基迪尔/
Akie	/燎卫/了卫/秋江/秋卫/秋枝/显卫/章卫/
Akiele	/阿基莱/
Akietsu	/秋悦/
Akif	/阿基夫/
Akifovic	/阿基福维奇/
Akifuji	/秋藤/
Akifuku	/章福/昭福/
Akifumi	/秋文/显文/章文/彰文/
Akifusa	/秋房/绍房/显房/章房/彰房/彰英/昭房/
Akifuyu	/秋冬/
Akiga	/阿基加/明贺/
Akigami	/明神/秋上/
Akigo	/秋吾/秋五/章吾/
Akigoro	/秋吾郎/秋五郎/
Akiguchi	/明口/秋口/
Akigusa	/秋草/
Akiha	/秋叶/
Akihama	/秋滨/
Akihara	/秋原/
Akiharu	/秋治/晓春/章春/章治/彰春/彰晴/彰治/昭春/昭晴/诠春/
Akihide	/观秀/明秀/秋秀/秋英/章秀/章英/彰秀/昭秀/昭英/诠秀/
Akihiko	/明彦/秋比古/秋彦/章彦/彰彦/昭彦/
Akihira	/明衡/明平/秋平/彰平/
Akihiro	/晃弘/明广/明弘/秋博/秋广/秋弘/显广/章广/章弘/彰博/彰广/彰宏/彰弘/昭浩/昭宏/昭弘/昭洋/
Akihisa	/明寿/秋久/秋寿/显久/章久/彰久/彰寿/昭寿/诠寿/
Akihito	/昌人/明仁/明人/秋仁/秋人/章仁/章人/彰仁/彰人/
Akiho	/秋保/秋帆/秋穗/
Akii	/阿基/
Akiie	/秋家/显家/章家/彰家/昭家/
Akiike	/秋池/
Akiiki	/阿基基/
Akiji	/秋次/秋路/秋司/秋治/章慈/章尔/章司/彰慈/彰次/彰尔/彰司/彰治/昭慈/昭司/
Akijinde	/阿基金德/
Akijiro	/明次郎/秋次郎/秋治郎/章次郎/章治郎/彰次郎/彰治郎/
Akijuro	/彰重郎/
Akik	/阿基克/
Akika	/秋香/
Akikado	/彰廉/
Akikage	/显影/
Akikane	/明兼/显兼/章兼/诠兼/
Akikata	/明贤/显方/
Akikatsu	/秋胜/显胜/
Akikawa	/秋川/
Akikaze	/秋风/章风/
Akiki	/阿基基/
Akikiyo	/口人/秋清/显清/
Akiko	/鉴子/晶子/明子/秋子/显子/章子/彰子/昭子/诠子/晖子/烨子/
Akikoto	/诠言/
Akikuni	/明国/秋国/显邦/显国/晓邦/晓国/
Akikura	/秋藏/
Akikusa	/秋草/
Akil	/阿基勒/阿克尔/
Akila	/阿基拉/
Akili	/阿基利/
Akilian	/阿基利昂/
Akilin	/阿基林/
Akilina	/阿基林娜/
Akilli	/阿克尔勒/
Akillioglu	/阿克尔勒奥卢/
Akilo	/阿基洛/
Akilou	/阿基卢/
Akilov	/阿基洛夫/
Akiltepe	/阿克尔泰佩/
Akilu	/阿基卢/
Akim	/阿基姆/阿克木/
Akima	/饱间/饱马/明磨/秋间/秋马/秋满/
Akimaliyev	/阿基马利耶夫/
Akiman	/阿克曼/
Akimaro	/显磨/章磨/昭磨/哲麻吕/
Akimaru	/秋丸/章丸/彰丸/
Akimasa	/晃正/鉴正/明正/秋正/显雅/显正/章昌/章将/章正/章政/彰昌/彰将/彰正/彰政/昭昌/昭将/昭政/晖昌/
Akimasu	/秋益/绍益/晁增/
Akimatsu	/秋松/彰松/
Akimbetov	/阿金别托夫/
Akimdzhanov	/阿基姆扎诺夫/
Akimenko	/阿基缅科/
Akimfi	/阿基姆菲/
Akimfii	/阿基姆菲/
Akimi	/明美/明实/明巳/秋实/秋巳/昭巳/
Akimichi	/明通/秋道/秋路/秋通/章道/章路/章通/彰道/彰路/彰通/昭道/
Akimine	/明峰/秋峰/
Akimitsu	/彬光/明光/明满/秋光/秋满/秋盈/日光/韶光/显光/显满/章光/章满/彰光/彰满/昭光/昭满/诠光/诠实/
Akimizu	/秋水/
Akimkin	/阿基姆金/
Akimochi	/诠持/
Akimochkin	/阿基莫奇金/
Akimori	/鉴盛/秋森/秋盛/显盛/章盛/章守/彰盛/彰守/昭盛/昭守/诠盛/
Akimoto	/秋本/秋基/秋元/显基/章基/章元/彰基/彰元/昭元/诠干/
Akimov	/阿基莫夫/
Akimovich	/阿基莫维奇/
Akimtsev	/阿基姆采夫/
Akimu	/阿基穆/
Akimune	/明宗/显统/显宗/章宗/彰宗/昭宗/
Akimura	/秋村/章村/彰村/昭村/
Akimushkin	/阿基穆什金/
Akimushkina	/阿基穆什金娜/
Akimzhanov	/阿基姆扎诺夫/
Akin	/阿金/阿肯/埃金/奥金/
Akina	/阿艺奈/阿支奈/阿支余/阿祗奈/秋名/
Akinaga	/明永/铭长/秋长/秋永/商长/显长/章长/章永/彰长/彰永/昭永/诠长/
Akinagamaro	/商长麻吕/
Akinaka	/显仲/章仲/
Akinal	/阿克纳尔/
Akinalp	/阿克纳尔普/
Akinami	/秋波/
Akinao	/秋尚/晓尚/晓直/章尚/章直/彰尚/昭直/诠直/
Akinari	/鉴成/明成/秋成/显成/昭就/
Akinbingol	/阿肯宾格尔/
Akinci	/阿肯哲/
Akincibay	/阿肯哲巴伊/
Akincigil	/阿肯哲吉尔/
Akincilar	/阿肯哲拉尔/
Akinciturk	/阿肯哲蒂尔克/
Akindes	/阿金代斯/
Akindin	/阿金金/
Akine	/秋根/秋音/秋子/
Akiner	/阿克内尔/
Akineri	/阿克内里/
Akinf	/阿金夫/
Akinfi	/阿金菲/
Akinfiev	/阿金菲耶夫/
Akinfii	/阿金菲/
Akinfiyev	/阿金菲耶夫/
Akinin	/阿基宁/
Akiniwa	/秋庭/
Akinjide	/阿金吉德/
Akinli	/阿肯勒/
Akinloye	/阿金洛耶/
Akino	/朝来野/秋野/
Akinobo	/秋野坊/
Akinobu	/昌信/明伸/明信/秋信/秋延/显伸/显信/章畅/章伸/章信/章宣/章延/彰畅/彰伸/彰信/彰宣/昭畅/昭进/昭信/昭宣/昭延/诠信/
Akinojo	/秋之丞/
Akinola	/阿基诺拉/
Akinori	/见教/明德/明诠/秋德/秋典/秋范/秋宪/秋则/日乘/日则/显法/显宪/显则/显智/晓教/晓升/章德/章典/章范/章教/章则/彰德/彰典/彰范/彰教/彰则/昭德/昭典/昭范/昭教/昭宪/诠范/
Akinoru	/章宜/
Akinoshin	/秋之进/
Akinosuke	/明之辅/明之介/明之佑/明之助/明之佐/秋之辅/秋之介/秋之佑/秋之助/秋之资/秋之佐/显之辅/显之介/显之亮/显之佑/显之助/显之资/显之佐/章之辅/章之介/章之佑/章之助/章之资/章之佐/
Akinoura	/荒浦/
Akinrinade	/阿金里纳德/
Akins	/埃金斯/
Akinsal	/阿肯萨尔/
Akinshin	/阿金申/
Akinskij	/阿金斯基/
Akinti	/阿金季/
Akintii	/阿金季/
Akintola	/阿金托拉/
Akinturk	/阿肯蒂尔克/
Akinwale	/阿金瓦莱/
Akinwande	/埃金旺德/
Akinyele	/阿金耶莱/
Akinyemi	/阿金耶米/
Akio	/赤城夫/朗生/明夫/明男/明尾/秋夫/秋男/秋生/秋穗/秋尾/秋雄/韶夫/绍夫/显穗/显雄/晓夫/晓男/晓生/阳雄/章夫/章朗/章男/章雄/彰夫/昭夫/昭男/昭雄/瑛夫/晁雄/
Akioka	/秋冈/
Akioki	/显兴/
Akiola	/阿基奥拉/
Akiomi	/显臣/章臣/
Akiosa	/商长/
Akioshi	/安艺凡/
Akipek	/阿基佩克/阿克佩克/
Akira	/炳/东/光/炯/具乐/俊/科良/垦/燎/了/卯/明/明乐/明荣/秋乐/秋良/融/审/审良/士/晤/宪/旭/阳/知/灼/璋/昊/睿/
Akiragi	/具木/
Akiraka	/焕/
Akiranaga	/晃长/
Akirayuki	/晃之/
Akirei	/明礼/
Akiri	/畔切/士/
Akiro	/显/彰郎/彰朗/
Akiroku	/秋录/昭录/昭绿/
Akis	/阿基斯/阿克什/
Akisada	/诚定/明贞/秋定/秋贞/显定/显贞/晓定/晓贞/章定/章贞/彰定/彰贞/昭定/昭贞/
Akisaka	/明坂/
Akisaku	/秋/
Akisato	/明达/秋里/秋乡/章里/章乡/彰里/彰乡/昭里/昭乡/
Akisawa	/秋泽/
Akise	/明濑/
Akishali	/阿克斯哈勒/
Akishi	/晶史/昭史/昭志/
Akishige	/鉴重/明重/秋成/秋茂/秋重/章成/章重/彰成/彰重/昭成/昭重/诠繁/诠重/
Akishika	/秋鹿/
Akishima	/秋岛/
Akishin	/阿基申/
Akishino	/秋筱/
Akishiro	/明城/
Akisik	/阿克舍克/
Akiska	/阿克斯卡/
Akisoferi	/阿基索费里/
Akisoglu	/阿基什奥卢/
Akister	/艾基斯特/
Akisue	/秋末/显季/
Akisuke	/明介/明佑/明助/明佐/秋辅/秋介/秋佑/秋助/秋资/秋佐/显辅/显介/显亮/显佑/显助/显资/显佐/章辅/章介/章佑/章助/章资/章佐/
Akit	/阿基特/
Akita	/安木田/饱田/禾明田/明田/秋田/昭多/檎田/
Akitada	/鉴忠/显忠/章忠/彰忠/昭忠/
Akitajo	/秋田诚/
Akitaka	/晋启/秋高/秋隆/秋孝/显高/显隆/显孝/章高/章隆/章乔/章孝/彰高/彰乔/彰孝/昭隆/昭乔/昭孝/
Akitake	/秋武/秋竹/章武/彰武/昭武/
Akitami	/秋民/章民/彰民/昭民/
Akitane	/鉴种/秋胤/显胤/章种/诠胤/
Akitani	/秋谷/
Akitaro	/秋太郎/韶太郎/
Akiteru	/昌光/明光/明辉/秋照/日照/晓辉/章辉/章照/彰辉/彰照/昭照/
Akito	/明人/
Akitoki	/明辰/秋时/显时/昭时/
Akitomi	/明富/秋富/
Akitomo	/明友/秋朝/秋共/秋友/显朝/显友/显知/晓友/晓知/章友/章知/彰友/彰知/昭知/晖友/
Akitora	/秋虎/
Akitoshi	/明利/秋利/商利/晓俊/晓利/晓敏/晓年/章俊/章利/章年/彰俊/彰敏/彰年/昭敏/昭年/璋敏/
Akitoyo	/鉴丰/
Akitsu	/秋津/
Akitsugi	/秋次/
Akitsugu	/见次/口次/明次/明继/秋次/秋接/秋嗣/商次/显继/章次/章继/章接/章嗣/彰次/彰继/彰接/彰嗣/昭接/昭嗣/
Akitsuka	/明冢/
Akitsuki	/秋月/昭月/着月/
Akitsumaro	/秋津摩/
Akitsuna	/秋绳/显纲/章纲/彰纲/昭纲/
Akitsune	/察常/明恒/秋恒/章常/章恒/章经/彰常/彰恒/彰经/昭常/昭恒/昭经/诠经/
Akitsura	/鉴连/明连/
Akiudo	/秋人/
Akiuji	/明氏/显氏/
Akiuma	/秋马/
Akiva	/阿基瓦/
Akivis	/阿基维斯/
Akiwa	/秋和/
Akiwumi	/阿基武米/
Akiya	/秋谷/秋弥/秋屋/秋也/章弥/章也/彰也/彰哉/昭弥/昭哉/
Akiyake	/秋宅/
Akiyama	/明山/秋山/彰山/
Akiyasu	/明保/秋保/秋静/秋康/显泰/章安/章保/章康/彰安/彰保/彰康/昭安/昭保/昭康/
Akiyev	/阿基耶夫/
Akiyo	/秋世/秋与/秋誉/昭代/昭世/
Akiyori	/观依/明赖/秋寄/显赖/章赖/彰赖/昭赖/诠赖/
Akiyosh	/爱义/秋芳/秋义/显宣/章良/昭嘉/
Akiyoshi	/爱义/明传/明善/明义/秋芳/秋好/秋吉/秋良/秋义/绍芳/显吉/显敬/显能/显喜/显宣/显义/晓敬/晓喜/章芳/章好/章嘉/章佳/章良/章义/彰芳/彰好/彰嘉/彰佳/彰美/彰义/昭好/昭嘉/昭敬/昭良/昭庆/昭义/诠吉/昱禧/晖吉/
Akiyuki	/鉴行/精之/明行/秋雪/秋之/显行/章行/章幸/章之/彰行/彰幸/彰元/彰之/昭如/昭行/
Akiz	/阿基兹/阿克兹/
Akizane	/显实/章实/昭实/
Akizato	/秋里/
Akizawa	/秋泽/
Akizo	/明造/秋藏/
Akizuki	/秋月/昭月/着月/
Akka	/阿卡/
Akkache	/阿卡什/
Akkad	/阿卡德/
Akkam	/阿卡姆/
Akkan	/阿克坎/
Akkanen	/阿卡宁/
Akkanlar	/阿克坎拉尔/
Akkaplan	/阿克卡普兰/
Akkar	/阿卡尔/
Akkari	/阿卡里/
Akkarpat	/阿克卡尔帕特/
Akkas	/阿克卡什/
Akkaya	/阿克卡亚/
Akkayan	/阿克卡扬/
Akkaynak	/阿克卡伊纳克/
Akkaz	/阿卡兹/
Akkent	/阿克肯特/
Akker	/奥凯尔/
Akkerman	/阿克凯尔曼/阿克曼/
Akkermans	/阿克曼/阿克曼斯/
Akkila	/阿基拉/
Akkilic	/阿克柯勒奇/
Akkin	/阿克肯/
Akkinen	/埃基宁/
Akkirpik	/阿克基尔皮克/
Akko	/阿库/
Akkoc	/阿克科奇/
Akkoca	/阿克科贾/
Akkok	/阿克柯克/
Akkor	/阿克科尔/
Akkord	/阿科德/阿科尔德/
Akkoyun	/阿克科云/
Akkoyunlu	/阿克科云卢/
Akkoz	/阿克柯兹/
Akkoze	/阿克柯泽/
Akkoziyev	/阿科济耶夫/
Akkum	/阿克库姆/
Akkuran	/阿克库兰/
Akkuratov	/阿库拉托夫/
Akkurd	/阿克库尔德/
Akkurt	/阿克库尔特/
Akkus	/阿克库什/
Akkutlu	/阿克库特卢/
Akkutlular	/阿克库特卢拉尔/
Akkuyas	/阿克库亚什/
Akkuzov	/阿库佐夫/
Akkuzu	/阿克库祖/
Akl	/阿克勒/
Aklan	/阿克兰/奥克隆/
Aklar	/阿克拉尔/
Akleja	/阿克莱亚/
Akli	/阿克利/奥克利/
Aklilu	/阿克利卢/
Aklog	/阿克洛格/
Aklouche	/阿克卢什/
Aklouk	/阿克卢克/
Akmadzic	/阿克马季奇/
Akmakji	/阿克马吉/
Akmal	/阿克马尔/
Akmamed	/阿克马梅德/
Akman	/阿克曼/
Akmanalp	/阿克马纳尔普/
Akmandor	/阿克曼多尔/
Akmaner	/阿克马内尔/
Akmanlar	/阿克曼拉尔/
Akmanoglu	/阿克曼奥卢/
Akmansoy	/阿克曼索伊/
Akmansu	/阿克曼苏/
Akmar	/阿克马尔/
Akmataliyev	/阿克马塔利耶夫/
Akmataly	/阿克马塔雷/
Akmatbekovich	/阿克马特别科维奇/
Akmatov	/阿克马托夫/
Akmen	/阿克曼/
Akmengu	/阿克曼居/
Akmentyn	/阿克缅滕/
Akmercan	/阿克梅尔詹/
Akmeric	/阿克梅里奇/
Akmermer	/阿克梅尔梅尔/
Akmete	/阿克梅特/
Akmil	/阿克米尔/
Akmirza	/阿克米尔扎/
Akmulla	/阿克穆拉/
Akmumcu	/阿克穆姆久/
Akmurad	/阿克穆拉德/
Akmurza	/阿克穆尔扎/
Akmut	/阿克穆特/
Aknai	/奥克瑙伊/
Aknar	/阿克纳尔/
Aknay	/奥克瑙伊/
Aknazarov	/阿克纳扎罗夫/
Aknin	/阿克南/
Aknok	/阿克诺克/
Aknouche	/阿克努什/
Aknoz	/阿克诺兹/
Aknuni	/阿克努尼/
Aknyev	/阿克尼耶夫/
Ako	/阿古/阿乎/阿江/阿科/安候/安香/赤广/赤生/赤穗/赤桶/
Akobo	/阿科博/
Akocsi	/奥科奇/
Akogashima	/阿子岛/安古岛/安子岛/
Akoghe	/阿科格/
Akogi	/阿古木/阿漕/
Akoglan	/阿科兰/
Akoglu	/阿克奥卢/
Akoguz	/阿科乌兹/
Akoji	/阿幸地/
Akok	/阿科克/
Akoka	/阿科卡/
Akol	/阿科尔/阿库勒/
Akola	/阿科拉/
Akoli	/阿科利/
Akolt	/埃科尔特/
Akolzin	/阿科利津/
Akom	/阿科姆/
Akon	/阿孔/
Akonat	/阿科纳特/
Akonder	/阿肯代尔/
Akone	/阿会根/
Akonel	/阿克内尔/
Akoner	/阿科内尔/阿克内尔/
Akongo	/阿孔戈/
Akono	/阿科诺/
Akontz	/阿孔茨/
Akoosh	/阿库什/
Akop	/阿科普/
Akopian	/阿科皮扬/
Akopov	/阿科波夫/
Akopova	/阿科波娃/
Akopovich	/阿科波维奇/
Akopyan	/阿科皮扬/
Akopyants	/阿科皮扬茨/
Akoren	/阿克伦/
Akos	/阿科什/
Akosenepyan	/阿科谢涅皮扬/
Akosfai	/阿科什福伊/
Akoshegyi	/阿科什海吉/
Akoshima	/阿子岛/
Akossou	/阿科苏/
Akoto	/阿科托/
Akouka	/阿库卡/
Akoulat	/阿库拉特/
Akoum	/阿库姆/
Akoun	/阿孔/
Akour	/阿库尔/
Akouri	/阿库里/
Akova	/阿科瓦/
Akovic	/阿科维奇/
Akoya	/阿呼弥/
Akoz	/阿克兹/
Akozer	/阿克泽尔/
Akpamgbo	/阿庞博/
Akpan	/阿克潘/
Akpay	/阿克帕伊/
Akpinar	/阿克珀纳尔/
Akpolat	/阿克波拉特/
Akporode	/阿克波罗德/
Akpoyoware	/阿克波约瓦雷/
Akpulat	/阿克普拉特/
Akram	/阿克拉姆/
Akrame	/阿克拉迈/
Akrami	/阿克拉米/
Akraoui	/阿克拉维/
Akrapov	/阿克拉波夫/
Akras	/埃克雷斯/
Akrasi	/阿克拉西/
Akratov	/阿克拉托夫/
Akrawi	/阿克拉维/
Akre	/阿克勒/
Akrenius	/阿克雷纽斯/
Akriche	/阿克里什/
Akriditis	/阿克里季蒂斯/
Akritas	/阿克里塔斯/
Akritides	/阿克里蒂季斯/
Akritidis	/阿克里蒂季斯/
Akrivakis	/阿克里瓦基斯/
Akrman	/阿克尔曼/
Akrmanova	/阿克尔曼诺娃/
Akrouche	/阿克鲁什/
Akrouk	/阿克鲁克/
Akrout	/阿克鲁特/
Akroyd	/阿克罗伊德/
Aksa	/阿克萨/阿克莎/
Aksac	/阿克萨奇/
Aksaci	/阿克萨彻/
Aksagarski	/阿克萨加尔斯基/
Aksagarsky	/阿克萨加尔斯基/
Aksak	/阿克萨克/
Aksakal	/阿克萨卡尔/
Aksakaloglu	/阿克萨卡尔奥卢/
Aksakov	/阿克萨科夫/
Aksal	/阿克萨尔/
Aksalin	/阿克萨伦/
Aksalur	/阿克萨卢尔/
Aksam	/阿克沙姆/
Aksamentov	/阿克萨缅托夫/
Aksamij	/阿克沙米/
Aksamit	/阿克萨米特/
Aksamitova	/阿克萨米托娃/
Aksamovic	/阿克沙莫维奇/
Aksan	/阿克桑/
Aksani	/阿克萨纳/
Aksar	/阿克萨尔/阿克沙尔/
Aksaray	/阿克萨拉伊/
Aksarin	/阿克萨林/
Aksay	/阿克萨伊/
Aksberg	/阿克斯贝里/
Akseki	/阿克塞基/
Aksel	/阿克塞尔/
Aksela	/阿克塞拉/
Akseli	/阿克塞利/
Akselin	/阿克塞林/
Akselinmaki	/阿克塞林迈基/
Aksell	/阿克塞尔/
Akselrod	/阿克塞尔罗德/
Akselsen	/阿克塞尔森/
Akselson	/阿克塞尔松/
Akselsson	/阿克塞尔松/
Aksen	/阿克申/阿克肖恩/
Aksenavichius	/阿克谢纳维丘斯/
Aksenenko	/阿克谢年科/
Aksenenkov	/阿克谢年科夫/
Aksenenok	/阿克谢涅诺克/
Aksener	/阿克谢内尔/
Aksenija	/阿克塞尼娅/
Aksenije	/阿克塞尼耶/
Aksenoff	/阿克塞诺夫/
Aksenopulos	/阿克塞诺普洛斯/
Aksenov	/阿克塞诺夫/阿克肖诺夫/
Aksenti	/阿克先季/
Aksentic	/阿克森蒂奇/
Aksentij	/阿克森蒂/
Aksentija	/阿克森蒂亚/
Aksentije	/阿克森蒂耶/
Aksentijevic	/阿克森蒂耶维奇/
Aksentjeff	/阿克森谢夫/
Aksenty	/阿克先季/
Aksentyev	/阿克先季耶夫/
Akser	/阿克塞尔/
Akses	/阿克塞斯/
Akseven	/阿克塞文/
Aksevil	/阿克塞维尔/
Akseymen	/阿克塞伊曼/
Akshad	/阿克沙德/
Akshay	/阿克沙伊/
Aksiansow	/阿克西安索夫/
Aksianzow	/阿克西安索夫/
Aksic	/阿克西奇/阿克希奇/
Aksijana	/阿克西亚娜/
Aksil	/阿克西/
Aksin	/阿克森/阿克欣/阿克辛/
Aksiniya	/阿克西尼娅/
Aksirin	/阿克希林/
Aksirov	/阿克西罗夫/
Aksit	/阿克希特/
Aksitsa	/阿克西特萨/
Aksiyote	/阿克西约特/
Aksman	/阿克斯曼/
Aksnes	/阿克斯内斯/
Akso	/阿克索/
Aksoley	/阿克索莱伊/
Aksominas	/阿克索米纳斯/
Aksomitas	/阿克索米塔斯/
Aksop	/阿克索普/
Aksoranan	/阿索拉南/
Aksoy	/阿克索伊/
Aksoyalp	/阿克索亚尔普/
Aksoycan	/阿克索伊詹/
Aksoyek	/阿克瑟耶克/
Aksoyer	/阿克索耶尔/
Aksoyoglu	/阿克索伊奥卢/
Aksozen	/阿克瑟曾/
Akst	/阿克斯特/
Aksu	/阿克苏/
Aksuek	/阿克叙埃克/
Aksultan	/阿克苏丹/
Aksulu	/阿克苏卢/
Aksumer	/阿克苏梅尔/阿克叙梅尔/
Aksun	/阿克松/
Aksuna	/阿克苏纳/
Aksunar	/阿克苏纳尔/
Aksuner	/阿克苏内尔/阿克叙内尔/
Aksungur	/阿克松古尔/
Aksura	/阿克舒拉/
Aksut	/阿克叙特/
Aksuyek	/阿克叙耶克/
Aksyon	/阿克肖恩/
Aksyonenko	/阿克肖年科/
Aksyonov	/阿克肖诺夫/
Aktac	/阿克塔奇/
Aktak	/阿克塔克/
Aktakke	/阿克塔凯/
Aktalay	/阿克塔拉伊/
Aktan	/阿克坦/
Aktar	/阿克塔尔/
Aktas	/阿克塔什/
Aktay	/阿克塔伊/
Aktayev	/阿克塔耶夫/
Aktekin	/阿克泰金/
Aktemur	/阿克泰米尔/
Akten	/阿克滕/
Aktener	/阿克泰内尔/
Akter	/阿克特尔/
Akterwall	/阿克特瓦尔/
Aktimur	/阿克蒂穆尔/
Aktin	/阿克廷/
Aktolga	/阿克托尔加/
Aktolunay	/阿克托卢纳伊/
Aktoprak	/阿克托普拉克/
Aktopuk	/阿克托普克/
Aktoros	/阿克托罗斯/
Aktouf	/阿克图夫/
Aktug	/阿克图/
Aktular	/阿克图拉尔/
Aktulga	/阿克图尔加/
Aktumen	/阿克蒂曼/
Aktun	/阿克廷/
Aktuna	/阿克图纳/
Aktunc	/阿克通奇/
Akturan	/阿克图兰/
Akture	/阿克蒂雷/
Akturel	/阿克蒂雷尔/
Akturk	/阿克蒂尔克/
Aktutay	/阿克图塔伊/
Aktuy	/阿克图伊/
Aku	/阿久/阿库/爱久/安久/恶/
Akuamoah	/阿夸莫亚/
Akuba	/饱庭/
Akubi	/日外/
Akuc	/阿库奇/
Akuchi	/安口/
Akucs	/奥库奇/
Akuffo	/阿库福/
Akugashima	/阿子岛/
Akugenda	/恶源太/
Akugenta	/恶源太/
Akugi	/具木/明木/
Akugur	/阿库乌尔/
Akuhanbo	/恶坂坊/
Akui	/阿久井/安久井/
Akujima	/阿子岛/
Akulenko	/阿库连科/
Akulin	/阿库林/
Akulina	/阿库林娜/
Akulinin	/阿库利宁/
Akulintsev	/阿库林采夫/
Akulov	/阿库洛夫/
Akulshin	/阿库利申/
Akum	/阿库姆/
Akuma	/阿曲/饱间/
Akumfi	/阿库姆菲/
Akumi	/饱海/渥美/渥味/
Akumo	/安昙/
Akumu	/阿库穆/
Akun	/阿金/
Akunal	/阿屈纳尔/
Akunami	/饱波/
Akunda	/阿孔达/
Akundin	/阿昆金/
Akune	/阿久根/莫称/莫根/莫弥/英祢/
Akunian	/阿库尼安/
Akuoko	/阿库奥科/
Akura	/安仓/饱等/饱浦/
Akuragawa	/阿久良川/
Akuras	/阿库拉斯/
Akurgal	/阿库尔加尔/
Akuryo	/恶灵/
Akusafu	/恶左府/
Akusawa	/阿久泽/芥泽/
Akushiro	/恶四郎/
Akusti	/阿库斯季/
Akusty	/阿库斯季/
Akuta	/饱田/芥/芥田/
Akutada	/芥田/
Akutagawa	/芥川/芥河/
Akutami	/芥见/
Akutazawa	/芥泽/
Akutin	/阿库京/
Akution	/阿库季翁/
Akuto	/阿久刀/阿久斗/
Akutogawa	/阿久刀川/
Akutokawa	/阿久刀川/
Akutomi	/抱富/
Akuzawa	/爱久泽/
Akuzenji	/恶禅师/
Akuzum	/阿屈聚姆/
Akvardar	/阿克瓦达尔/
Akvilonov	/阿克维洛诺夫/
Akwa	/阿克瓦/阿夸/
Akwaa	/阿克瓦/
Akwadji	/阿夸吉/
Akwah	/阿克瓦/
Akwala	/阿夸拉/
Akwasi	/阿夸西/
Akwegyiram	/阿奎吉拉姆/
Akwei	/阿克韦/
Akyalcin	/阿克亚尔琴/
Akyalin	/阿克亚伦/
Akyamac	/阿克亚马奇/
Akyan	/阿克扬/
Akyar	/阿克亚尔/
Akyatan	/阿克亚坦/
Akyavas	/阿克亚瓦什/
Akyay	/阿基艾/
Akyaz	/阿克亚兹/
Akyazan	/阿克亚赞/
Akyazi	/阿克亚泽/
Akyazici	/阿克亚泽哲/
Akyeampong	/阿基安蓬/
Akyel	/阿克耶尔/
Akyemopong	/阿基莫蓬/
Akyigit	/阿克伊伊特/
Akyil	/阿克伊尔/
Akyildiz	/阿克耶尔德兹/
Akylangongo	/阿基兰贡戈/
Akylbek	/阿克尔别克/
Akylbekov	/阿克尔别科夫/
Akylor	/阿基勒/
Akyn	/阿肯/
Akyol	/阿克约尔/
Akyu	/秋保/
Akyuma	/阿丘玛/
Akyurek	/阿克于雷克/
Akyurt	/阿克尤尔特/
Akyuz	/阿克于兹/
Akyuzalp	/阿克于扎尔普/
Akyuzlu	/阿克于兹吕/
Akyyev	/阿克耶夫/
Akzam	/阿克扎姆/
Akzambak	/阿克赞巴克/
Akzar	/阿克扎尔/
Akzhigitov	/阿克日吉托夫/
Al	/阿比德/阿卜杜勒/阿尔/遏/控/马苏德/纳乌里/斡/轧/谒/霭/
Al-Aghil	/阿吉勒/
Ala	/阿拉/
Alaa	/阿拉/
Alaarvi	/阿拉埃尔维/
Alaattin	/阿拉丁/
Alabaca	/阿拉巴萨/
Alaback	/阿拉巴克/
Alabadi	/阿拉瓦迪/
Alabarbe	/阿拉巴布/
Alabarce	/阿拉瓦尔塞/
Alabart	/阿拉瓦尔特/
Alabaster	/阿拉巴斯特/
Alabastros	/阿拉瓦斯特罗斯/
Alabau	/阿拉沃/
Alabawi	/阿拉巴维/
Alabay	/阿拉巴伊/
Alabegun	/阿拉贝金/
Alaber	/阿拉韦尔/奥洛贝尔/
Alabert	/阿拉贝尔/
Alabin	/阿拉宾/
Alablanche	/阿拉布朗什/
Alabouvette	/阿拉布韦特/
Alabov	/阿拉博夫/
Alabrune	/阿拉布吕纳/
Alaburdene	/阿拉布尔杰涅/
Alaburic	/阿拉布里奇/
Alabyan	/阿拉比扬/
Alaca	/阿拉贾/
Alacaatli	/阿拉贾阿特勒/
Alacakaptan	/阿拉贾卡普坦/
Alacakir	/阿拉恰克尔/
Alacala	/阿拉卡拉/
Alacali	/阿拉贾勒/
Alacalioglu	/阿拉贾勒奥卢/
Alacam	/阿拉恰姆/
Alacan	/阿拉詹/
Alacapinar	/阿拉贾珀纳尔/
Alaci	/阿拉奇/
Alacia	/阿拉西亚/
Alacid	/阿拉西德/
Alacio	/阿拉西奥/
Alacoque	/阿拉科克/
Alacrino	/阿拉克里诺/
Alacs	/奥拉奇/奥洛奇/
Alacuart	/阿拉夸尔特/
Alacyr	/阿拉西尔/
Aladame	/阿拉达姆/
Aladar	/阿拉达尔/
Aladatyan	/阿拉达强/
Aladdin	/阿拉丁/
Aladefa	/阿拉德法/
Aladel	/阿拉代尔/
Aladenise	/阿拉德尼兹/
Aladenize	/阿拉德尼兹/
Aladerne	/阿拉代纳/
Aladi	/奥洛迪/
Aladics	/奥洛迪奇/
Aladin	/阿拉丹/阿拉丁/阿拉金/
Aladino	/阿拉迪诺/
Aladjadji	/阿拉贾吉/
Aladje	/阿拉杰/
Aladjov	/阿拉德约夫/
Aladli	/阿拉德勒/
Alados	/阿拉多斯/
Aladov	/阿拉多夫/
Aladpoosh	/阿拉德普什/
Aladren	/阿拉德伦/
Aladro	/阿拉德罗/
Aladrovic	/阿拉德罗维奇/
Aladuena	/阿拉杜埃尼亚/
Aladyev	/阿拉季耶夫/
Aladzhadzhyan	/阿拉贾江/
Aladzhalov	/阿拉贾洛夫/
Aladzhalova	/阿拉贾洛娃/
Aladzhalyan	/阿拉贾良/
Aladzhem	/阿拉杰姆/
Aladzic	/阿拉季奇/
Alaeddin	/阿拉丁/
Alaeddine	/阿拉丁/
Alaeddinoglu	/阿拉丁奥卢/
Alaehto	/阿莱赫托/
Alaejos	/阿莱霍斯/
Alaez	/阿莱斯/
Alafaix	/阿拉费克斯/
Alafe	/阿拉费/
Alafi	/阿拉菲/
Alafon	/阿拉丰/
Alafont	/阿拉丰特/
Alafort	/阿拉福特/
Alafuzov	/阿拉富佐夫/
Alagador	/阿拉加多尔/
Alagappa	/阿拉加帕/
Alagarim	/阿拉加林/
Alager	/阿拉格尔/
Alagesan	/阿拉格桑/
Alageyik	/阿拉盖伊克/
Alagez	/阿拉格兹/
Alagh	/阿拉格/
Alaghehmandan	/阿拉盖曼丹/
Alagic	/阿拉吉奇/
Alagille	/阿拉吉耶/
Alagiyawanna	/阿拉吉亚万纳/
Alagoa	/阿拉戈阿/
Alagoinha	/阿拉戈伊尼亚/
Alagol	/阿拉格尔/
Alagon	/阿拉贡/
Alagov	/阿拉戈夫/
Alagoz	/阿拉格兹/
Alagozoglu	/阿拉格兹奥卢/
Alaguero	/阿拉格罗/
Alagueros	/阿拉格罗斯/
Alaguibel	/阿拉吉韦尔/
Alaguide	/阿拉吉德/
Alaguillaume	/阿拉纪尧姆/
Alagun	/阿拉金/
Alagur	/阿拉居尔/
Alahame	/阿拉海梅/
Alahan	/阿拉汗/
Alahassa	/阿拉哈萨/
Alahaviala	/阿拉海维埃莱/
Alaheikka	/阿拉黑卡/
Alahonko	/阿拉洪科/
Alahuhta	/阿拉胡赫塔/
Alahverdiev	/阿拉赫韦尔季耶夫/
Alai	/阿莱/
Alaica	/阿拉伊察/
Alaide	/阿莱德/
Alaikhon	/阿莱洪/
Alailima	/阿拉伊利马/
Alaimo	/阿莱莫/
Alain	/阿拉因/阿兰/
Alaine	/阿莱纳/
Alainen	/阿莱宁/
Alainez	/阿莱内斯/
Alaini	/艾尼/
Alair	/阿莱尔/
Alaire	/阿莱尔/
Alais	/阿莱/
Alaiso	/阿莱索/
Alaiwa	/阿莱瓦/
Alaix	/阿莱/阿莱克斯/
Alaiz	/阿莱斯/
Alaize	/阿莱兹/
Alaizeau	/阿莱佐/
Alaizola	/阿莱索拉/
Alaja	/阿拉亚/
Alajaafs	/阿拉耶夫斯/
Alajaaski	/阿拉耶斯基/
Alajaasko	/阿拉耶斯克/
Alajam	/阿拉贾姆/
Alajarin	/阿拉哈林/
Alajbeg	/阿拉伊贝格/
Alajbegovic	/阿拉伊贝戈维奇/
Alajmi	/阿拉杰米/
Alajoki	/阿拉约基/
Alajos	/奥洛约什/
Alajouanine	/阿拉茹瓦尼纳/
Alajoutsijarvi	/阿拉约齐耶尔维/
Alajtner	/奥洛伊特纳/
Alajuntti	/阿拉云蒂/
Alajuuma	/阿拉尤马/
Alak	/奥洛克/
Alakallaanvaara	/阿拉卡兰瓦拉/
Alakan	/阿拉坎/
Alakangas	/阿拉坎加斯/
Alakankimaki	/阿拉坎基迈基/
Alakant	/阿拉坎特/
Alakarhu	/阿拉卡尔胡/
Alakari	/阿拉卡里/
Alakas	/阿拉卡斯/
Alakavuk	/阿拉卡武克/
Alakhverdiyev	/阿拉赫韦尔季耶夫/
Alakhverdyan	/阿拉赫韦尔江/
Alakiikonen	/阿拉基科宁/
Alako	/阿拉科/
Alakoc	/阿拉科奇/
Alakoskela	/阿拉科斯凯拉/
Alakoski	/阿拉科斯基/
Alakseychyk	/阿列克谢奇克/
Alaksza	/奥洛克绍/
Alakujala	/阿拉库亚拉/
Alakukku	/阿拉库库/
Alakulppi	/阿拉库尔皮/
Alakurikka	/阿拉库里卡/
Alakurt	/阿拉库尔特/
Alakurtti	/阿拉库尔蒂/
Alakus	/阿拉库什/
Alakusu	/阿拉库舒/
Alal	/阿拉勒/
Alalaakkola	/阿拉莱克莱/
Alalain	/阿拉兰/
Alalammi	/阿拉拉米/
Alalbasanz	/阿拉尔瓦桑斯/
Alali	/阿拉利/
Alalia	/阿拉利亚/
Alalinard	/阿拉利纳尔/
Alalof	/阿拉洛夫/
Alaloglu	/阿拉尔奥卢/
Alalon	/阿拉隆/
Alalouf	/阿拉卢夫/
Alalovic	/阿拉洛维奇/
Alaluf	/阿拉卢夫/
Alaluoma	/阿拉卢奥马/
Alaluoto	/阿拉卢奥托/
Alaluusua	/阿拉卢苏阿/
Alam	/阿拉姆/阿兰/
Alama	/阿拉马/阿拉默/
Alamachere	/阿拉马谢尔/
Alamaki	/阿拉迈基/
Alaman	/阿拉曼/阿勒曼/
Alamand	/阿拉芒/
Alamanis	/阿拉马尼斯/
Alamanni	/阿拉曼尼/
Alamannisto	/阿拉门尼斯特/
Alamany	/阿拉马尼/
Alamanzon	/阿拉曼松/
Alamara	/阿拉马拉/
Alamaraz	/阿拉马拉斯/
Alamargot	/阿拉马戈/
Alamariu	/阿勒马留/
Alamartin	/阿拉马丁/
Alamartine	/阿拉马丁/
Alamaru	/阿勒马鲁/
Alamasse	/阿拉马塞/
Alamattila	/阿拉马蒂拉/
Alamaunu	/阿拉毛努/
Alamayehu	/阿莱马耶胡/
Alambert	/阿兰贝特/
Alambillaga	/阿兰比利亚加/
Alambradas	/阿兰布拉达斯/
Alambre	/阿兰布雷/
Alambres	/阿兰布雷斯/
Alambret	/阿朗布雷/
Alamdar	/阿拉姆达尔/
Alamddine	/阿拉姆丁/
Alamdou	/阿朗杜/
Alame	/阿拉迈/
Alameda	/阿拉梅达/
Alamego	/阿拉梅戈/
Alameh	/阿拉梅赫/
Alamehta	/阿拉梅赫泰/
Alamein	/阿勒明/
Alamenka	/阿拉门卡/
Alamercery	/阿拉梅塞里/
Alameri	/阿拉梅里/
Alametsa	/阿拉梅采/
Alamettala	/阿拉梅泰莱/
Alameuniere	/阿拉默尼埃/
Alamgir	/阿拉姆吉尔/
Alami	/阿拉米/
Alamichel	/阿拉米歇尔/
Alamiekkaoja	/阿拉米耶考亚/
Alamigeon	/阿拉米容/
Alamiie	/阿勒默耶/
Alamil	/阿拉米勒/
Alamilla	/阿拉米利亚/
Alamillo	/阿拉米略/
Alamillos	/阿拉米略斯/
Alamin	/阿拉明/
Alamingeon	/阿拉曼容/
Alaminos	/阿拉米诺斯/
Alamir	/阿拉米尔/
Alamita	/阿勒米策/
Alamo	/阿拉莫/
Alamome	/阿拉莫姆/
Alamon	/阿拉蒙/
Alamont	/阿拉蒙/
Alamoreanu	/阿勒莫雷亚努/
Alamos	/阿拉莫斯/
Alamouti	/阿拉穆蒂/
Alampiyev	/阿兰皮耶夫/
Alamshahi	/阿拉姆沙希/
Alamsi	/阿拉姆西/
Alamsjah	/阿兰夏/
Alamsuddin	/阿拉姆斯丁/
Alamsyah	/阿兰夏/
Alamuddine	/阿拉姆丁/
Alamy	/阿拉米/
Alamyshev	/阿拉梅舍夫/
Alan	/阿兰/阿朗/艾伦/
Alanaatu	/阿拉纳图/
Alanalp	/阿拉纳尔普/
Alanampa	/阿拉南帕/
Alanara	/阿拉内雷/
Alanay	/阿拉纳伊/
Alanbay	/阿兰巴伊/
Alanbena	/阿兰贝纳/
Alanbrooke	/阿兰布鲁克/
Alanche	/阿朗什/
Alanci	/阿兰哲/
Alanco	/阿兰科/
Alancon	/阿朗松/
Aland	/阿兰/
Alander	/阿兰德/
Alandete	/阿兰德特/
Alandez	/阿兰德斯/
Alandh	/阿兰/
Alandi	/阿兰迪/
Alandia	/阿兰迪亚/
Alando	/阿兰多/
Alandrieu	/阿朗德里厄/
Alandroal	/阿兰德罗阿尔/
Alandski	/阿兰茨基/
Alandsky	/阿兰茨基/
Alane	/阿兰/
Alanen	/阿拉宁/
Alanenpaa	/阿拉宁佩/
Alaner	/阿拉内尔/
Alaneri	/阿拉内里/
Alangoa	/阿兰戈阿/
Alangoya	/阿兰戈亚/
Alani	/阿拉尼/
Alanic	/阿拉尼克/
Alaniesse	/阿拉尼耶斯/
Alaniou	/阿拉尼乌/
Alanis	/阿拉尼斯/
Alaniva	/阿拉尼瓦/
Alanko	/阿兰科/
Alankoc	/阿兰科奇/
Alankoja	/阿兰科亚/
Alankomaa	/阿兰科马/
Alankus	/阿兰库什/阿兰库斯/
Alanli	/阿兰勒/
Alanne	/阿兰内/
Alano	/阿拉诺/
Alanoglu	/阿兰奥卢/
Alanoja	/阿拉诺亚/
Alanon	/阿拉尼翁/
Alanore	/阿拉诺尔/
Alanovic	/阿拉诺维奇/
Alansal	/阿兰萨尔/
Alanson	/阿兰森/
Alant	/阿朗/奥兰特/
Alanti	/阿兰蒂/
Alanur	/阿拉努尔/
Alanurhanim	/阿拉努尔哈纳姆/
Alanus	/阿拉尼斯/
Alanya	/阿拉尼亚/
Alanyali	/阿兰亚勒/
Alanzavez	/阿兰萨韦斯/
Alao	/阿朗/
Alaoci	/阿拉奥西/
Alaoglu	/阿拉奥卢/
Alaoja	/阿劳亚/
Alaoua	/阿拉瓦/
Alaoui	/阿拉维/
Alaouie	/阿拉维/
Alapaholuoma	/阿拉帕霍卢奥马/
Alapera	/阿拉佩雷/
Alapere	/阿拉佩雷/
Alapetite	/阿拉珀蒂特/
Alapfy	/奥洛普菲/
Alaphilippe	/阿拉菲利普/
Alapi	/奥洛皮/
Alapiessa	/阿拉皮耶萨/
Alapin	/阿拉平/
Alapinar	/阿拉珀纳尔/
Alapirtti	/阿拉皮尔蒂/
Alaplantif	/阿拉普朗蒂夫/
Alapoikela	/阿拉波伊凯拉/
Alapont	/阿拉蓬/阿拉蓬特/
Alapoti	/阿拉波蒂/
Alapuro	/阿拉普罗/
Alaputto	/阿拉普托/
Alapvari	/奥洛普瓦里/
Alapy	/奥洛皮/
Alar	/阿拉尔/
Alaraappana	/阿拉拉帕纳/
Alaranta	/阿拉兰塔/
Alarcao	/阿拉桑/
Alarcia	/阿拉西亚/
Alarcio	/阿拉西奥/
Alarco	/阿拉科/
Alarcon	/阿拉尔孔/阿拉尔松/阿拉孔/
Alarcos	/阿拉科斯/
Alard	/阿拉尔/
Alardent	/阿拉登特/
Alardet	/阿拉尔代/
Alardin	/阿拉尔丹/
Alares	/阿拉雷斯/
Alaret	/阿拉雷/
Alargic	/阿拉尔吉奇/
Alargunsoro	/阿拉贡索罗/
Alari	/阿拉里/
Alaria	/阿拉里亚/
Alaric	/阿拉里克/
Alarico	/阿拉里科/
Alarie	/阿拉里/
Alarik	/阿拉里克/
Alariksson	/阿拉里克斯松/
Alarilla	/阿拉里利亚/
Alario	/阿拉里奥/
Alarios	/阿拉里奥斯/
Alaris	/阿拉里/
Alarma	/阿拉尔马/
Alarnes	/阿拉内斯/
Alarotu	/阿拉罗图/
Alaroze	/阿拉罗兹/
Alart	/阿拉尔/
Alarte	/阿拉尔特/
Alarto	/阿拉尔托/
Alary	/阿拉里/
Alarza	/阿拉尔萨/
Alas	/阿拉斯/
Alasaari	/阿拉萨里/
Alasager	/奥尔萨杰/
Alasalmi	/阿拉萨尔米/
Alasara	/阿拉萨拉/
Alascio	/阿拉西奥/
Alasdair	/阿拉斯代尔/
Alasentie	/阿拉森蒂耶/
Alasev	/阿拉塞夫/
Alasevic	/阿拉塞维奇/
Alasheyev	/阿拉舍耶夫/
Alasia	/阿拉西亚/
Alasimone	/阿拉西蒙娜/
Alasimonen	/阿拉西莫宁/
Alasjarvi	/阿拉斯耶尔维/
Alasmaa	/阿拉斯马/
Alasoini	/阿拉索伊尼/
Alasovic	/阿拉索维奇/
Alasow	/阿拉苏/
Alaspaa	/阿拉斯佩/
Alassane	/阿拉萨内/
Alassani	/阿拉萨尼/
Alassauniere	/阿拉索尼埃/
Alasseur	/阿拉瑟/
Alassimone	/阿拉西蒙娜/
Alassio	/阿拉西奥/
Alassoeur	/阿拉瑟尔/
Alassounouma	/阿拉苏努马/
Alastair	/阿拉斯泰尔/
Alastalo	/阿拉斯塔洛/
Alaste	/阿拉斯特/
Alastrue	/阿拉斯特鲁埃/
Alastruey	/阿拉斯特鲁埃/
Alastuey	/阿拉斯蒂埃/阿拉斯图埃/
Alasulu	/阿拉苏卢/
Alasuutari	/阿拉苏塔里/
Alasuvanto	/阿拉苏万托/
Alasvuo	/阿拉斯沃/
Alasya	/阿拉斯亚/
Alat	/阿拉特/
Alata	/阿拉塔/
Alatalo	/阿拉塔洛/
Alatan	/阿拉坦/
Alatas	/阿拉塔什/阿拉塔斯/
Alatay	/阿拉塔伊/
Alateinte	/阿拉坦特/
Alatera	/阿拉泰雷/
Alaterre	/阿拉泰尔/
Alatervo	/阿拉特沃/
Alatic	/阿拉蒂奇/
Alatli	/阿拉特勒/
Alaton	/阿拉顿/
Alatre	/阿拉特/
Alatri	/阿拉特里/
Alatriste	/阿拉特里斯特/
Alatyppo	/阿拉蒂珀/
Alatyrtsev	/阿拉特尔采夫/
Alauddin	/阿拉丁/
Alaude	/阿洛德/
Alaudete	/阿劳德特/
Alaudi	/阿劳季/
Alaume	/阿洛姆/
Alaurent	/阿洛朗/
Alauro	/阿洛罗/
Alaux	/阿洛/
Alauze	/阿洛兹/
Alauzen	/阿洛藏/
Alauzet	/阿洛泽/
Alauzier	/阿洛齐耶/
Alava	/阿拉瓦/
Alavahtola	/阿拉瓦赫托拉/
Alavaikko	/阿拉瓦伊科/
Alavanja	/阿拉瓦尼亚/
Alavanos	/阿拉瓦诺斯/
Alavantic	/阿拉万蒂奇/
Alavaranta	/阿拉瓦兰塔/
Alavarez	/阿拉瓦雷斯/
Alavedra	/阿拉韦德拉/
Alavera	/阿拉韦拉/
Alaverdov	/阿拉韦尔多夫/
Alaverdyan	/阿拉韦尔江/
Alavesa	/阿拉韦萨/
Alavi	/阿拉维/
Alavia	/阿拉维亚/
Alavirevic	/阿拉维雷维奇/
Alaviuhkola	/阿拉维乌赫科拉/
Alavkt	/阿拉夫克特/
Alavoine	/阿拉瓦纳/
Alavuk	/阿拉武克/
Alavuotunki	/阿拉沃通基/
Alawi	/阿拉维/
Alawiah	/阿拉维亚/
Alawiyah	/阿拉维亚/
Alawneh	/阿劳奈/
Alaxai	/奥洛克索伊/
Alay	/阿莱/
Alaya	/阿拉亚/
Alayan	/阿拉扬/
Alaybayoglu	/阿拉伊巴伊奥卢/
Alaybegovici	/阿拉伊贝戈维奇/
Alaybeyi	/阿拉伊贝伊/
Alaybeyoglu	/阿拉伊贝伊奥卢/
Alaye	/阿莱耶/
Alayeli	/阿拉耶利/
Alayli	/阿拉伊勒/阿莱利/
Alayo	/阿拉约/
Alayrac	/阿莱拉克/
Alayrangues	/阿莱朗格/
Alayza	/阿莱萨/
Alaz	/阿拉兹/
Alazan	/阿拉赞/
Alazard	/阿拉扎尔/
Alazay	/阿拉泽/
Alazet	/阿拉泽/
Alazoula	/阿拉祖拉/
Alazrachi	/阿拉斯拉奇/
Alazragui	/阿拉斯拉吉/
Alazraki	/阿拉斯拉基/
Alb	/阿尔布/奥尔布/
Alba	/阿尔芭/阿尔巴/阿尔瓦/奥尔鲍/
Albac	/阿尔巴克/
Albacar	/阿尔瓦卡尔/
Albacete	/阿尔瓦塞特/
Albach	/阿尔巴赫/奥尔鲍奇/
Alback	/阿尔贝克/
Albacke	/阿尔巴克/
Albadalejo	/阿尔瓦达莱霍/
Albaeus	/阿尔贝乌斯/
Albafouille	/阿尔巴富耶/
Albagachiyev	/阿尔巴加奇耶夫/
Albage	/阿尔博格/
Albaglar	/阿尔巴拉尔/
Albagli	/阿尔巴利/
Albaharevic	/阿尔巴哈雷维奇/
Albahari	/阿尔巴哈里/
Albahary	/阿尔巴阿里/
Albahri	/阿尔巴赫里/
Albaicin	/阿尔瓦伊辛/
Albaidh	/比德/
Albain	/阿尔班/
Albaina	/阿尔瓦伊纳/
Albaine	/阿尔拜内/
Albaitero	/阿尔瓦伊特罗/
Albaiu	/阿尔巴尤/
Albaizar	/阿尔瓦伊萨尔/
Albala	/阿尔巴拉/阿尔瓦拉/
Albalad	/阿尔瓦拉德/
Albaladejo	/阿尔瓦拉德霍/
Albalat	/阿尔巴拉/阿尔瓦拉特/
Albalate	/阿尔瓦拉特/
Albalato	/阿尔瓦拉托/
Albali	/阿尔巴利/
Albalrak	/阿尔巴尔拉克/
Albalrakoglu	/阿尔巴尔拉克奥卢/
Albamar	/阿尔瓦马尔/
Alban	/阿尔班/阿尔邦/阿尔万/阿勒班/奥尔班/奥尔本/
Albanchez	/阿尔万切斯/
Albanda	/阿尔班达/
Albandea	/阿尔万德亚/
Albane	/阿尔巴纳/
Albanel	/阿尔巴内尔/
Albanenses	/阿尔伯嫩西斯/
Albanes	/阿尔巴纳/阿尔瓦内斯/
Albanese	/阿尔巴纳斯/阿尔巴内塞/
Albangozar	/阿尔万戈萨尔/
Albanhac	/阿尔巴纳克/
Albani	/阿尔瓦尼/
Albania	/阿尔瓦尼亚/
Albanil	/阿尔瓦尼尔/
Albano	/阿尔巴诺/阿尔瓦诺/
Albanopol	/阿尔巴诺波尔/
Albanov	/阿尔巴诺夫/
Albans	/阿尔邦/奥尔本斯/
Albanus	/阿尔巴努斯/
Albany	/阿尔巴尼/阿尔瓦尼/奥尔巴尼/
Albar	/阿尔巴/阿尔巴尔/阿尔瓦尔/
Albarado	/阿尔瓦拉多/
Albaran	/阿尔瓦兰/
Albarca	/阿尔瓦卡/
Albarck	/阿尔巴克/
Albardao	/阿尔巴当/
Albardeiro	/阿尔巴代罗/
Albardiaz	/阿尔瓦迪亚斯/
Albardonedo	/阿尔瓦多内多/
Albareda	/阿尔瓦雷达/
Albarede	/阿尔巴雷德/
Albarel	/阿尔巴雷尔/
Albarellos	/阿尔瓦雷略斯/
Albares	/阿尔巴尔/阿尔巴雷斯/阿尔瓦雷斯/
Albaret	/阿尔巴雷/
Albarez	/阿尔瓦雷斯/
Albaric	/阿尔巴里克/
Albarino	/阿尔瓦里尼奥/
Albaro	/阿尔巴罗/阿尔瓦罗/
Albarosa	/阿尔巴罗萨/
Albarra	/阿尔瓦拉/
Albarracin	/阿尔瓦拉辛/
Albarral	/阿尔瓦拉尔/
Albarran	/阿尔巴兰/阿尔巴朗/阿尔瓦兰/
Albarranc	/阿尔巴朗/
Albarranz	/阿尔瓦兰斯/
Albarraque	/阿尔巴拉克/
Albart	/阿尔瓦特/
Albary	/阿尔巴里/
Albas	/阿尔瓦斯/
Albasan	/阿尔瓦桑/
Albasanz	/阿尔瓦桑斯/
Albaserrada	/阿尔瓦塞拉达/
Albasini	/阿尔瓦西尼/
Albassier	/阿尔巴西耶/
Albastroiu	/阿尔伯斯特罗尤/
Albat	/阿尔巴特/
Albatani	/巴塔尼/
Albateni	/阿尔巴捷尼/
Albatenio	/阿尔巴特尼奥/
Albateny	/阿尔巴捷尼/
Albath	/阿尔巴特/
Albatros	/阿尔瓦特罗斯/
Albaud	/阿尔博/
Albault	/阿尔博/
Albaum	/阿尔鲍姆/
Albaut	/阿尔博/
Albay	/阿尔巴伊/阿尔贝/
Albaya	/阿尔瓦亚/
Albayda	/阿尔瓦伊达/
Albayez	/阿尔巴耶/
Albayrak	/阿尔巴伊拉克/
Albaz	/阿尔巴/阿勒巴兹/
Albe	/阿尔贝/阿尔布/
Albea	/阿尔韦亚/
Albeanu	/阿尔贝亚努/
Albear	/阿尔韦亚尔/
Albeata	/阿尔贝亚策/阿尔贝亚察/
Albeaux	/阿尔博/
Albeck	/阿尔贝克/
Albecker	/阿尔贝克/
Albeda	/阿尔贝达/
Albedinsky	/阿尔贝丁斯基/
Albee	/阿尔比/
Albeed	/比德/
Albega	/阿尔韦加/
Albegov	/阿尔别戈夫/
Albei	/阿尔贝伊/
Albeiu	/阿尔贝尤/
Albeker	/阿尔贝克/
Albela	/阿尔韦拉/
Albelda	/阿尔贝尔达/阿尔韦尔达/
Albeldea	/阿尔韦德亚/
Albelin	/阿尔贝林/
Albella	/阿尔韦利亚/
Albely	/奥尔拜伊/
Albem	/阿尔邦/
Albema	/阿尔贝马/
Albeman	/阿尔贝曼/
Albemark	/阿尔贝马克/
Albemarle	/阿尔比马尔/
Alben	/阿尔邦/阿尔本/阿尔文/
Albena	/阿尔贝纳/
Albencoa	/阿尔文科亚/
Albendea	/阿尔文德亚/
Albendin	/阿尔文丁/
Albendoa	/阿尔文多亚/
Albenga	/阿尔本加/
Albeni	/阿尔贝尼/奥尔拜尼/
Albeniz	/阿尔韦尼斯/
Albenque	/阿尔邦克/
Albenski	/阿尔边斯基/
Albensky	/阿尔边斯基/
Albensoder	/阿尔本瑟德/
Albentose	/阿尔文托塞/
Alber	/阿伯/阿尔贝/阿尔韦尔/奥尔贝尔/
Alberani	/阿尔贝拉尼/
Alberat	/阿尔韦拉特/
Alberbury	/奥尔伯布里/
Alberca	/阿尔贝卡/阿尔韦尔卡/
Alberdi	/阿尔韦迪/
Alberding	/阿伯丁/
Alberdingk	/阿尔伯丁克/
Alberegts	/阿尔贝雷茨/
Alberes	/阿尔贝雷斯/
Alberg	/阿尔贝里/
Alberga	/阿尔贝加/阿尔韦尔加/
Albergaria	/阿尔贝加里亚/
Alberge	/阿尔贝热/
Alberger	/阿尔伯格/
Albergne	/阿尔贝涅/
Albergueiro	/阿尔贝盖罗/
Alberguilla	/阿尔韦吉利亚/
Albergulla	/阿尔韦古利亚/
Alberi	/阿尔贝里/阿尔韦里/
Alberic	/阿伯里克/阿尔贝里克/
Alberich	/阿尔韦里奇/
Alberico	/阿尔贝里科/阿尔韦里科/
Albering	/阿尔贝林/
Alberini	/阿尔贝里尼/阿尔韦里尼/
Alberio	/阿尔贝里奥/
Alberite	/阿尔韦里特/
Alberman	/阿尔贝曼/
Albernaz	/阿尔贝纳斯/
Albernhe	/阿尔贝涅/
Alberni	/阿尔贝尼/阿尔韦尼/
Alberny	/阿尔贝尼/
Albero	/阿尔贝罗/阿尔韦罗/
Alberola	/阿尔贝罗拉/阿尔韦罗拉/
Alberoni	/阿尔贝罗尼/
Alberovsky	/阿尔贝罗夫斯基/
Alberowsky	/奥尔拜罗夫斯基/
Alberquilla	/阿尔韦基利亚/
Alberro	/阿尔贝罗/
Alberruche	/阿尔韦鲁切/
Albers	/阿伯斯/阿尔贝斯/阿尔韦斯/
Albersmann	/阿尔贝斯曼/
Albersmeyer	/阿尔贝斯迈尔/
Albert	/阿尔贝/阿尔贝特/阿尔韦特/艾伯特/奥尔贝特/
Alberta	/阿尔贝塔/阿尔韦塔/艾伯塔/
Albertal	/阿尔韦塔尔/
Albertas	/阿尔贝塔斯/
Albertat	/阿尔贝塔/
Albertazzie	/艾伯塔齐/
Alberte	/阿尔贝特/阿尔韦特/
Alberth	/阿尔贝特/奥尔贝特/
Albertha	/阿尔韦塔/
Alberti	/阿尔贝蒂/阿尔韦蒂/
Albertin	/阿尔贝坦/阿尔贝廷/
Albertina	/阿尔贝蒂娜/艾伯蒂娜/
Albertine	/阿尔贝蒂娜/艾伯丁/
Albertinelli	/阿尔贝蒂内利/
Albertini	/阿尔贝蒂尼/阿尔韦蒂尼/
Albertino	/阿尔贝蒂诺/阿尔韦蒂诺/
Albertis	/阿尔贝蒂斯/
Alberto	/阿尔贝托/阿尔韦托/
Albertolli	/阿尔贝托利/
Albertos	/阿尔韦托斯/
Albertov	/阿尔贝托夫/
Albertova	/阿尔贝托娃/
Albertovich	/阿尔贝托维奇/
Alberts	/阿尔贝茨/艾伯茨/
Albertson	/阿尔贝特松/艾伯森/
Albertsson	/阿尔贝特松/
Albertsworth	/艾伯茨沃思/
Albertus	/阿尔贝图斯/阿尔韦图斯/艾伯塔斯/
Alberty	/阿尔贝蒂/艾伯蒂/奥尔拜吉/
Albertz	/阿尔贝茨/阿尔韦茨/艾伯茨/
Albertzon	/阿尔贝特松/
Alberu	/阿尔韦鲁/
Albery	/奥伯里/
Albes	/阿尔贝/阿尔贝斯/阿尔韦斯/
Albesa	/阿尔韦萨/
Albescu	/阿尔贝斯库/
Albespan	/阿尔韦斯潘/
Albespy	/阿尔贝斯皮/
Albessard	/阿尔贝萨/
Albessart	/阿尔贝萨/
Albestain	/阿尔韦斯坦/
Albestean	/阿尔贝斯泰安/
Albesteanu	/阿尔贝斯泰亚努/
Albet	/阿尔贝/
Albetz	/阿尔韦茨/
Albeverio	/阿尔贝韦里奥/
Albez	/阿尔韦斯/
Albi	/阿尔比/阿尔维/
Albia	/阿尔比亚/
Albiac	/阿尔比亚克/阿尔维亚克/
Albiach	/阿尔比亚克/阿尔维亚奇/
Albiat	/阿尔比亚/
Albicares	/阿尔维卡雷斯/
Albich	/阿尔比赫/
Albici	/阿尔比奇/
Albicker	/阿尔比克尔/
Albicocco	/阿尔比科科/
Albiczuk	/阿尔比丘克/
Albie	/阿尔比/
Albiel	/阿尔维尔/
Albieru	/阿尔比耶鲁/
Albiete	/阿尔维特/
Albig	/阿尔比格/阿尔比希/
Albiges	/阿尔比热/阿尔比热斯/
Albignac	/阿尔比尼亚克/
Albihn	/阿尔宾/
Albiin	/阿尔宾/
Albijana	/阿尔比亚娜/
Albijanda	/阿尔比扬达/
Albijanic	/阿尔比亚尼奇/
Albillo	/阿尔维略/
Albillos	/阿尔维略斯/
Albin	/阿尔班/阿尔宾/阿尔文/奥尔宾/
Albina	/阿尔比娜/阿尔比纳/阿尔宾娜/
Albinana	/阿尔维尼亚纳/
Albinas	/阿尔比纳斯/
Albine	/阿尔比娜/
Albinel	/阿尔比内尔/
Albinelli	/阿尔维内利/
Albinescu	/阿尔比内斯库/
Albinet	/阿尔比内/
Albing	/阿尔宾/
Albini	/阿尔比尼/
Albino	/阿尔比诺/阿尔维诺/阿勒比努/
Albinoni	/阿尔比诺尼/
Albinova	/阿尔比诺娃/
Albinovic	/阿尔比诺维奇/
Albinovich	/阿尔比诺维奇/
Albinowski	/阿尔比诺夫斯基/
Albinski	/阿尔宾斯基/
Albinson	/阿尔宾松/
Albinsson	/阿尔宾松/
Albinus	/阿尔比努斯/
Albinzon	/阿尔宾松/
Albiol	/阿尔维奥尔/
Albion	/阿尔比恩/阿尔比翁/
Albiousse	/阿尔比乌斯/
Albir	/阿尔维尔/
Albis	/阿尔比斯/奥尔比什/
Albiser	/阿尔比塞/
Albisetti	/阿尔比塞蒂/
Albisi	/奥尔比希/
Albisor	/阿尔比绍尔/
Albisoru	/阿尔比绍鲁/
Albissin	/阿尔比森/
Albistegui	/阿尔维斯特吉/
Albistur	/阿尔维斯图尔/
Albisu	/阿尔维苏/
Albita	/阿尔比塔/
Albite	/阿尔维特/
Albiti	/阿尔维蒂/
Albitos	/阿尔维托斯/
Albitre	/阿尔比特/
Albitski	/阿尔比茨基/
Albitsky	/阿尔比茨基/
Albitz	/奥尔比茨/
Albiz	/阿尔维斯/
Albizu	/阿尔比祖/阿尔维苏/
Albizua	/阿尔维苏亚/
Albizuri	/阿尔维苏里/
Albizzati	/阿尔比扎蒂/阿尔维萨蒂/
Albl	/阿尔布尔/
Alblova	/阿尔布洛娃/
Albo	/阿尔博/阿尔沃/
Alboaica	/阿尔博艾卡/阿尔博艾克/
Albogas	/阿尔博加斯/
Albohair	/阿尔博艾尔/
Alboiu	/阿尔博尤/
Alboldt	/阿尔博尔特/
Albolote	/阿尔沃洛特/
Albon	/阿尔邦/阿尔本/
Albonesy	/阿尔博内西/
Albonetti	/阿尔博内蒂/
Alboni	/阿尔博尼/
Albonici	/阿尔博尼奇/阿尔沃尼西/
Alboniga	/阿尔沃尼加/
Albons	/阿尔邦斯/
Albontosa	/阿尔翁托萨/
Albor	/阿尔博尔/阿尔沃尔/
Albora	/阿尔博拉/
Alboran	/阿尔沃兰/
Albord	/阿尔博/
Albordt	/阿尔博特/
Albore	/阿尔博雷/
Alboreca	/阿尔沃雷卡/
Albores	/阿尔沃雷斯/
Alborg	/阿尔堡/阿尔沃格/
Alborno	/阿尔博诺/阿尔沃诺/
Albornos	/阿尔沃诺斯/
Albornoz	/阿尔沃诺斯/
Alboros	/阿尔沃罗斯/
Alborov	/阿尔博罗夫/
Alborta	/阿尔沃塔/
Albosta	/阿尔博斯塔/
Albot	/阿尔博/阿尔博特/
Albota	/阿尔博塔/
Alboteanu	/阿尔博泰亚努/
Albou	/阿尔布/
Albouhair	/阿尔布艾尔/
Albouis	/阿尔布伊/
Albouker	/阿尔布克/
Alboukieck	/阿尔布凯克/
Albourne	/奥尔伯恩/
Albourt	/阿尔布/
Alboussiere	/阿尔布西埃/
Albouy	/阿尔布伊/
Albouze	/阿尔布兹/
Albov	/阿尔博夫/
Albox	/阿尔沃克斯/
Alboy	/阿尔布瓦/
Albrand	/阿尔布兰德/阿尔布朗/
Albrandt	/阿尔布兰特/
Albray	/阿尔布雷/
Albre	/阿尔布尔/
Albrecht	/阿尔布雷布特/阿尔布雷赫特/阿尔布雷克特/阿尔布雷希特/
Albrechtova	/阿拉布雷赫托娃/
Albrechtovich	/奥尔布赖奇托维奇/
Albrechtson	/阿尔布雷克特松/
Albrechtsson	/阿尔布雷克特松/
Albrecktsson	/阿尔布雷克特松/
Albree	/奥尔布里/
Albreht	/阿尔布雷赫特/
Albrekht	/阿尔布雷希特/
Albrektson	/阿尔布雷克松/
Albrektsson	/阿尔布雷克特松/
Albrespy	/阿尔布雷斯皮/
Albret	/阿尔布雷/
Albretsen	/阿尔布雷特森/
Albrich	/阿尔布里希/
Albrier	/阿尔布里耶/
Albrieu	/阿尔夫列乌/
Albrieux	/阿尔布里厄/
Albright	/奥尔布赖特/
Albring	/阿尔布林/
Albriton	/奥尔布里顿/
Albrittain	/奥尔布里顿/
Albritton	/奥尔布里顿/
Albrizzi	/阿尔布里齐/
Albro	/奥尔布罗/
Albrodt	/阿尔布罗特/
Albs	/阿尔布斯/
Albu	/阿尔布/奥尔布/
Albucher	/阿尔比谢/
Albuczy	/奥尔布齐/
Albuera	/阿尔武埃拉/
Albuerne	/阿尔武尔内/
Albufeira	/阿尔布费拉/
Albufera	/阿尔比费拉/阿尔武费拉/
Albuia	/阿尔武亚/
Albuica	/阿尔布伊克/
Albuin	/阿尔武因/
Albuisech	/阿尔维塞奇/
Albuisson	/阿尔比松/
Albuixech	/阿尔维塞奇/
Albujar	/阿尔武哈尔/
Albujer	/阿尔武赫尔/
Albuleanu	/阿尔布莱亚努/
Albulescu	/阿尔布列斯库/
Albulet	/阿尔布莱特/
Albuletu	/阿尔布莱楚/
Albulj	/阿尔布利/
Albulov	/阿尔布洛夫/
Albumina	/阿尔武米纳/
Albumovic	/阿尔布莫维奇/
Albuquerque	/阿尔布开克/
Alburquerque	/阿尔武凯克/
Albury	/阿尔武里/奥尔伯里/
Albus	/阿尔布斯/
Albusac	/阿尔武萨克/
Albusaz	/阿尔武萨斯/
Albuscheit	/阿尔布沙伊特/
Albusel	/阿尔布谢尔/
Albusoiu	/阿尔布绍尤/
Albut	/阿尔布茨/阿尔布特/
Albutiu	/阿尔布丘/
Albuysech	/阿尔维塞奇/
Alby	/阿尔比/
Alca	/阿尔卡/
Alcaba	/阿尔卡瓦/
Alcabas	/阿尔卡巴/
Alcabes	/阿尔卡布/
Alcabez	/阿尔卡贝/
Alcabour	/阿尔卡布尔/
Alcacarenho	/阿尔卡萨雷尼奥/
Alcacer	/阿尔卡塞尔/
Alcada	/阿尔萨达/
Alcadas	/阿尔萨达斯/
Alcade	/阿尔卡德/
Alcaeus	/阿尔凯奥斯/
Alcahuz	/阿尔卡乌斯/
Alcaide	/阿尔卡伊德/阿尔凯德/
Alcain	/阿尔卡因/阿尔坎/
Alcaina	/阿尔凯纳/
Alcainas	/阿尔凯尼亚斯/
Alcainca	/阿尔卡因萨/
Alcaine	/阿尔凯内/
Alcaino	/阿尔凯诺/
Alcaire	/阿尔凯雷/
Alcais	/阿尔凯/
Alcajor	/阿尔卡霍尔/
Alcakovic	/阿尔恰科维奇/
Alcala	/阿尔卡拉/
Alcalay	/阿尔卡拉伊/阿尔卡莱/
Alcalde	/阿尔卡尔德/
Alcali	/阿尔贾勒/
Alcama	/阿尔卡马/
Alcambar	/阿尔坎巴尔/
Alcami	/阿尔卡米/
Alcamo	/阿尔卡莫/
Alcan	/阿尔坎/阿尔康/
Alcanas	/阿尔卡尼亚斯/
Alcanda	/阿尔坎达/
Alcander	/阿尔坎德/
Alcandre	/阿尔康德尔/
Alcani	/阿尔卡尼/
Alcaniz	/阿尔卡尼斯/
Alcantara	/阿尔坎塔拉/
Alcantra	/阿尔坎特拉/
Alcantu	/阿尔坎图/
Alcantud	/阿尔坎图德/
Alcanus	/阿尔卡努斯/
Alcape	/阿尔卡佩/
Alcar	/阿尔恰尔/
Alcarado	/阿尔卡拉多/
Alcaravela	/阿尔卡拉韦拉/
Alcaraz	/阿尔卡拉斯/
Alcarazo	/阿尔卡拉索/
Alcaria	/阿尔卡里亚/
Alcarias	/阿尔卡里亚斯/
Alcarpe	/阿尔卡佩/
Alcarraga	/阿尔卡拉加/
Alcarranza	/阿尔卡兰萨/
Alcarria	/阿尔卡里亚/
Alcarva	/阿尔卡瓦/
Alcarve	/阿尔卡韦/
Alcaso	/阿尔卡索/
Alcat	/阿尔卡/阿尔卡特/
Alcatrao	/阿尔卡特朗/
Alcaud	/阿尔科/
Alcausa	/阿尔考萨/
Alcauz	/阿尔考斯/
Alcay	/阿尔凯/
Alcayaga	/阿尔卡亚加/
Alcayde	/阿尔凯德/
Alcayna	/阿尔凯纳/
Alcayne	/阿尔凯内/
Alcaz	/阿尔卡兹/阿尔恰兹/
Alcazamsa	/阿尔卡萨姆萨/
Alcazansa	/阿尔卡桑萨/
Alcazar	/阿尔卡萨/阿尔卡扎/
Alcazaren	/阿尔卡萨伦/
Alcazo	/阿尔卡索/
Alce	/阿尔斯/
Alcebiades	/阿尔塞比亚德斯/
Alceda	/阿尔塞达/
Alcedo	/阿尔塞多/
Alcee	/阿尔塞/
Alcega	/阿尔塞加/
Alcelay	/阿尔塞莱/
Alcema	/阿尔塞马/
Alcen	/阿尔森/
Alceni	/阿尔塞尼/
Alcenius	/阿尔塞纽斯/
Alceo	/阿尔塞奥/
Alcerreca	/阿尔塞雷卡/
Alcerro	/阿尔塞罗/
Alceste	/阿尔切斯特/
Alcester	/阿尔采斯特/奥尔斯特/
Alceu	/阿尔塞乌/
Alcevic	/阿尔切维奇/
Alcevski	/阿尔切夫斯基/
Alch	/阿尔奇/
Alcher	/阿尔谢/
Alchevskaya	/阿尔切夫斯卡娅/
Alchevski	/阿尔切夫斯基/
Alchevsky	/阿尔切夫斯基/
Alchon	/阿尔康/
Alci	/阿尔哲/
Alciati	/阿尔恰蒂/
Alciatore	/阿尔恰托雷/
Alcibar	/阿尔西瓦尔/
Alcibiade	/阿尔奇比亚德/
Alcibiades	/阿尔西维亚德斯/
Alcide	/阿尔奇德/阿尔西德/
Alcides	/阿尔西德斯/
Alcido	/阿尔西多/
Alcina	/阿尔西纳/
Alcinda	/阿尔辛达/
Alcindo	/阿尔辛多/
Alcino	/阿尔西诺/
Alciphron	/阿尔西弗龙/
Alcir	/阿尔西尔/
Alcira	/阿尔西拉/
Alcivar	/阿尔西瓦/
Alcoba	/阿尔科瓦/
Alcobaca	/阿尔科巴萨/
Alcobas	/阿尔科瓦斯/
Alcobenda	/阿尔科文达/
Alcobendas	/阿尔科文达斯/
Alcober	/阿尔科韦尔/
Alcobia	/阿尔科比亚/阿尔科维亚/
Alcobre	/阿尔科夫雷/
Alcoceba	/阿尔科塞瓦/
Alcocer	/阿尔科塞尔/
Alcock	/阿尔科克/
Alcoforado	/阿尔科福拉多/
Alcoitia	/阿尔科伊蒂亚/
Alcojar	/阿尔科哈尔/
Alcojol	/阿尔科霍尔/
Alcojor	/阿尔科霍尔/
Alcol	/阿尔科尔/
Alcolado	/阿尔科拉多/
Alcolea	/阿尔科莱亚/
Alcolombre	/阿尔科隆布尔/
Alcom	/阿尔科姆/
Alcomada	/阿尔科马达/
Alcombensa	/阿尔孔本萨/
Alcon	/阿尔孔/
Alconada	/阿尔科纳达/
Alconbury	/奥尔肯伯里/
Alconchel	/阿尔孔切尔/
Alconchil	/阿尔孔奇尔/
Alconero	/阿尔科内罗/
Alcor	/阿尔科尔/
Alcord	/阿尔乔尔德/
Alcoriza	/阿尔科里萨/
Alcorld	/阿尔科尔德/
Alcorlo	/阿尔科洛/
Alcormada	/阿尔科马达/
Alcorn	/奥尔康/
Alcorta	/阿尔科塔/
Alcott	/奥尔科特/
Alcouffe	/阿尔库夫/
Alcoulombre	/阿尔库隆布雷/
Alcove	/阿尔科夫/
Alcover	/阿尔科韦尔/
Alcoy	/阿尔科伊/
Alcoz	/阿尔科斯/
Alcoza	/阿尔科萨/
Alcser	/奥尔切尔/
Alcsut	/奥尔丘特/
Alcsuti	/奥尔丘蒂/
Alcuaz	/阿尔夸斯/
Alcuberro	/阿尔库韦罗/
Alcubierre	/阿尔库别雷/阿尔库维雷/
Alcubilla	/阿尔库维利亚/
Alcuin	/阿尔昆/
Alcuson	/阿尔库松/
Alda	/阿尔达/
Aldabariz	/阿尔达瓦里斯/
Aldabe	/阿尔达布/阿尔达韦/
Aldabergenov	/阿尔达别尔格诺夫/
Aldabero	/阿尔达韦罗/
Aldaco	/阿尔达科/
Aldadanov	/阿尔达达诺夫/
Aldag	/阿尔达格/
Aldaiturriaga	/阿尔代图里亚加/
Aldakimov	/阿尔达基莫夫/
Aldalen	/阿尔达伦/
Aldalurlasa	/阿尔达卢拉萨/
Aldama	/阿尔达马/
Aldamiz	/阿尔达米斯/
Aldamov	/阿尔达莫夫/
Aldan	/阿尔丹/阿拉坦/奥尔登/
Aldana	/阿尔达纳/
Aldanas	/阿尔达纳斯/
Aldanes	/阿尔达涅斯/
Aldanmazlar	/阿尔丹马兹拉尔/
Aldanondo	/阿尔达农多/
Aldanov	/阿尔达诺夫/
Aldao	/阿尔道/
Aldar	/阿尔达尔/
Aldaravi	/阿尔达拉维/
Aldaria	/阿尔达里亚/
Aldarias	/阿尔达里亚斯/
Aldasi	/阿尔达希/
Aldasoro	/阿尔达索罗/
Aldave	/阿尔达韦/
Aldavero	/阿尔达韦罗/
Aldax	/阿尔达/
Alday	/阿尔代/
Aldaz	/阿尔达斯/
Aldazabal	/阿尔达萨瓦尔/
Aldbo	/阿尔德博/
Aldbring	/阿尔德布林/
Alde	/阿尔德/
Aldea	/阿尔代亚/阿尔德亚/
Aldeamil	/阿尔德亚米尔/
Aldeano	/阿尔德亚诺/
Aldeanu	/阿尔代亚努/
Aldeanueva	/阿尔德亚努埃瓦/
Aldebert	/阿尔德贝/
Aldeborg	/阿尔德堡/
Aldebring	/阿尔德布林/
Aldeburgh	/奥尔德伯勒/
Aldecoa	/阿尔德科亚/
Aldee	/阿勒迪/
Aldegard	/阿尔德高/
Aldegonde	/阿尔德贡德/
Aldegrever	/阿尔德格雷弗/
Aldeguer	/阿尔德格尔/奥尔迪格/
Aldegunde	/阿尔德贡德/
Aldehag	/阿尔德哈格/
Aldeheim	/阿尔德海姆/
Aldehuela	/阿尔德韦拉/
Aldehuelo	/阿尔德韦洛/
Aldeia	/阿尔德亚/
Aldejohann	/阿尔德约翰/
Aldelin	/阿尔德林/
Aldemark	/阿尔德马克/
Aldemir	/阿尔代米尔/
Aldemira	/阿尔德米拉/
Alden	/阿尔登/奥尔登/
Aldena	/阿尔德纳/
Aldenberg	/阿尔登贝里/
Aldener	/阿尔德纳/
Aldenfo	/阿尔登福/
Aldenhag	/阿尔登哈格/
Aldenham	/奥尔德纳姆/
Aldenheim	/阿尔登海姆/
Aldenhoff	/阿尔登霍夫/
Aldenhovel	/阿尔登赫韦尔/
Aldenhoven	/阿尔登霍芬/
Aldenklint	/阿尔登克林特/
Aldenlov	/阿尔登勒夫/
Aldenroth	/阿尔登罗特/
Aldenrud	/阿尔登鲁德/
Aldensand	/阿尔登桑德/
Aldensell	/阿尔登泽尔/
Aldenstam	/阿尔登斯坦/
Aldenstig	/阿尔登斯蒂格/
Aldenstrom	/阿尔登斯特伦/
Aldenueva	/阿尔德努埃瓦/
Alder	/阿尔德/奥尔德/
Alderback	/阿尔德贝克/
Alderbayev	/阿尔杰尔巴耶夫/
Alderbrant	/阿尔德布兰特/
Alderbro	/阿尔德布罗/
Alderdice	/奥尔德代斯/
Aldereguia	/阿尔德雷吉亚/
Alderete	/阿尔德雷特/
Alderfer	/奥尔德弗/
Alderfors	/阿尔德福什/
Aldergren	/阿尔德格伦/
Alderhed	/阿尔德赫德/
Alderheim	/阿尔德海姆/
Alderhult	/阿尔德胡尔特/
Alderico	/阿尔德里科/
Alderin	/阿尔德林/
Alderkrans	/阿尔德克兰斯/
Alderlid	/阿尔德利德/
Alderman	/奥尔德曼/
Aldermyr	/阿尔德米尔/
Aldero	/阿尔德勒/
Alders	/阿尔德斯/奥尔德斯/
Aldersey	/奥尔德西/
Aldersjo	/阿尔德舍/
Aldersley	/阿尔德斯莱/
Alderson	/奥尔德森/
Alderstad	/阿尔德斯塔德/
Aldersten	/阿尔德斯滕/
Aldert	/阿尔德特/埃尔德特/
Alderton	/奥尔德顿/
Alderus	/阿尔德鲁斯/
Aldervall	/阿尔德瓦尔/
Aldescu	/阿尔代斯库/
Aldesiu	/阿尔代休/
Aldestam	/阿尔德斯塔姆/
Aldesten	/阿尔德斯滕/
Aldestrom	/阿尔德斯特伦/
Aldevarn	/阿尔德韦恩/
Aldevio	/阿尔德维奥/
Aldgard	/阿尔德高/
Aldham	/奥尔德姆/
Aldhammer	/阿尔德哈默/
Aldheim	/阿尔德海姆/
Aldhelm	/奥尔德赫姆/
Aldhizer	/奥尔迪泽/
Aldiano	/阿尔迪亚诺/
Aldibay	/阿尔德巴伊/
Aldibey	/阿尔德贝伊/
Aldic	/阿尔迪奇/
Aldica	/阿尔迪克/
Aldigeri	/阿尔迪赫里/
Aldighero	/阿尔迪盖罗/
Aldim	/阿尔丁/
Aldin	/阿尔丹/阿尔丁/奥尔丁/
Alding	/阿尔丁/
Aldinge	/阿尔丁格/
Aldinger	/阿尔丁格/阿尔丁赫尔/阿尔丁杰/
Aldington	/奥尔丁顿/
Aldinhas	/阿尔迪尼亚斯/
Aldini	/阿尔迪尼/
Aldiouma	/阿勒迪乌马/
Aldir	/阿尔迪尔/
Aldis	/阿尔迪/阿尔迪斯/
Aldisert	/奥尔迪泽特/
Aldisio	/阿尔迪西奥/
Aldiz	/阿尔迪斯/
Aldjawi	/阿尔查维/
Aldman	/阿尔德曼/
Aldo	/阿尔多/奥尔多/
Aldobelyi	/奥尔多拜伊/
Aldobera	/阿尔多韦拉/
Aldobrandini	/阿尔多布兰迪尼/
Aldoescu	/阿尔多埃斯库/
Aldogan	/阿尔多安/
Aldoiu	/阿尔多尤/
Aldokhin	/阿尔多欣/
Aldoma	/阿尔多马/
Aldomar	/阿尔多马尔/
Aldona	/阿尔东娜/
Aldonas	/奥尔多纳斯/
Aldonce	/阿尔东斯/
Aldonza	/阿尔东萨/
Aldor	/阿尔多/阿尔多尔/
Aldora	/阿尔多拉/
Aldorete	/阿尔多雷特/
Aldorf	/阿尔多夫/
Aldorfan	/阿尔多凡/
Aldorfova	/阿尔多福娃/
Aldos	/阿尔多斯/
Aldoshin	/阿尔多申/
Aldott	/阿尔多特/
Aldous	/奥尔德斯/
Aldovera	/阿尔多韦拉/
Aldred	/奥尔德雷德/
Aldrede	/阿尔德雷德/
Aldredge	/奥尔德雷奇/
Aldric	/阿尔德里克/
Aldrich	/奥尔德里奇/
Aldridge	/奥尔德里奇/
Aldrin	/阿尔德兰/阿尔德林/奥尔德林/
Aldringen	/阿尔德林根/
Aldro	/阿德罗/
Aldrovandi	/阿尔德罗万迪/
Aldrover	/阿尔德罗韦尔/
Aldrup	/阿尔德鲁普/
Aldstam	/阿尔德斯坦/
Alduan	/阿尔杜安/
Alduini	/阿尔杜伊尼/
Alduleanu	/阿尔杜莱亚努/
Aldulescu	/阿尔杜列斯库/
Aldunate	/阿尔杜纳特/
Aldunge	/阿尔敦格/
Alduren	/阿尔迪伦/
Aldus	/阿尔杜斯/
Aldushin	/阿尔杜申/
Alduvin	/阿尔杜温/
Alduy	/阿尔迪/
Aldvin	/阿尔德温/
Aldwin	/阿尔德温/
Aldworth	/奥德沃思/
Ale	/阿莱/阿勒/
Aleandro	/阿莱安德罗/
Aleardi	/阿莱亚尔迪/
Aleardo	/阿莱亚尔多/
Aleat	/阿莱亚特/
Alebarbe	/阿勒巴布/
Alebardo	/阿莱瓦多/
Alebe	/阿莱布/
Aleberg	/阿莱贝里/
Alebic	/阿莱比奇/
Aleborn	/阿莱博恩/
Alebrant	/阿莱布兰特/
Alebrink	/阿莱布林克/
Alebris	/阿莱布里斯/
Alebua	/阿莱布亚/
Aleby	/阿勒比/
Alec	/阿历克/亚历克/
Alecian	/阿勒西昂/
Alecio	/阿莱西奥/
Aleck	/亚历克/
Alecki	/阿莱基/
Aleckovic	/阿莱奇科维奇/
Alecrim	/阿莱克林/
Alecsa	/阿列克萨/
Alecsandrescu	/亚历山德雷斯库/
Alecsandri	/亚历山德里/
Alecsandrina	/亚历山德里娜/
Alecsandru	/亚历山德鲁/
Alecse	/阿列克谢/
Alecsiu	/阿列克休/
Alecsuc	/阿列克苏克/
Alectoridi	/阿列克托里迪/
Alecu	/阿列库/
Aledinski	/阿列金斯基/
Aledinsky	/阿列金斯基/
Aledo	/阿莱多/
Aleem	/阿利姆/
Aleemal	/阿利马尔/
Aleev	/阿列耶夫/
Aleeva	/阿列耶娃/
Alef	/阿莱夫/阿勒夫/阿利夫/阿列夫/
Alefeld	/阿勒费尔德/
Alefelder	/阿勒费尔德/
Aleff	/阿勒夫/
Alefjall	/阿莱菲耶尔/
Aleflod	/阿莱夫洛德/
Alefti	/阿列夫季/
Aleftii	/阿列夫季/
Aleftin	/阿列夫京/
Aleftina	/阿列夫京娜/
Alegacone	/阿莱加孔/
Alegra	/阿莱格拉/
Alegre	/阿莱格尔/阿莱格雷/
Alegren	/阿莱格伦/
Alegret	/阿莱格雷特/
Alegrete	/阿莱格雷特/
Alegrett	/阿莱格雷特/
Alegria	/阿莱格里亚/
Alegrias	/阿莱格里亚斯/
Alegrim	/阿莱格林/
Alegrio	/阿莱格里奥/
Alehelm	/阿莱赫尔姆/
Aleholm	/阿莱霍尔姆/
Alehorn	/阿勒霍恩/
Alei	/阿莱伊/
Aleiandro	/阿历杭德罗/
Aleida	/阿莱达/
Aleijadinho	/阿莱雅迪尼奥/
Aleikhem	/阿列伊赫姆/
Aleinikov	/阿列伊尼科夫/
Aleith	/阿莱特/
Aleiva	/阿莱瓦/
Aleix	/亚历克斯/
Aleixo	/阿莱绍/
Alejadinho	/阿莱雅迪尼奥/
Alejalde	/阿莱哈尔德/
Alejandra	/亚历杭德拉/
Alejandre	/亚历杭德雷/
Alejandria	/亚历杭德里亚/
Alejandrina	/亚历杭德里纳/
Alejandrino	/亚历杭德里诺/
Alejandro	/亚历杭德罗/
Alejano	/亚历哈诺/
Alejo	/阿莱霍/
Alejos	/阿莱霍斯/
Alek	/阿列克/
Aleka	/阿莱卡/
Alekan	/阿勒康/
Alekber	/阿列克别尔/
Aleke	/阿莱克/
Alekhin	/阿廖欣/
Alekhnovich	/阿列赫诺维奇/
Alekian	/阿勒基安/
Alekin	/阿列金/
Alekna	/阿列克纳/
Aleknene	/阿列克涅涅/
Aleko	/阿莱科/
Alekos	/阿莱科斯/
Alekper	/阿列克佩尔/
Alekperov	/阿列克佩罗夫/
Aleks	/亚历克斯/
Aleksa	/阿列克萨/阿列克莎/
Aleksakhin	/阿列克萨欣/
Aleksan	/阿列克桑/
Aleksanda	/亚历山达/
Aleksandar	/亚历山大/
Aleksander	/亚历山大/
Aleksandersen	/亚历山大森/
Aleksandr	/亚历山大/
Aleksandra	/亚历山德拉/
Aleksandras	/亚历山德拉斯/
Aleksandravichius	/亚历山德拉维丘斯/
Aleksandrenko	/亚历山德连科/
Aleksandric	/亚历山德里奇/
Aleksandrida	/亚历山德丽达/
Aleksandrija	/亚历山德里娅/
Aleksandrije	/亚历山德里耶/
Aleksandrin	/亚历山德林/
Aleksandrina	/亚历山德里娜/亚历山德林娜/
Aleksandriski	/亚历山德里斯基/
Aleksandrisky	/亚历山德里斯基/
Aleksandro	/亚历山德罗/
Aleksandrov	/亚历山德罗夫/
Aleksandrova	/亚历山德罗娃/
Aleksandrovic	/亚历山德罗维奇/
Aleksandrovich	/亚历山德罗维奇/
Aleksandrovska	/亚历山德罗夫斯卡/
Aleksandrovski	/亚历山德罗夫斯基/
Aleksandrovsky	/亚历山德罗夫斯基/
Aleksandrow	/亚历山德罗夫/
Aleksandrowicz	/亚历山德罗维奇/
Aleksandrs	/亚历山大斯/
Aleksandruk	/亚历山德鲁克/
Aleksanian	/阿列克萨尼扬/
Aleksanin	/阿列克萨宁/
Aleksankin	/阿列克桑金/
Aleksanov	/阿列克萨诺夫/
Aleksanyan	/阿列克萨尼扬/
Aleksashenko	/阿列克萨申科/
Aleksashin	/阿列克萨申/
Aleksat	/阿列克萨特/
Alekseev	/阿列克谢耶夫/
Alekseevich	/阿列克谢耶维奇/
Alekseevna	/阿列克谢耶芙娜/
Alekseevski	/阿列克谢耶夫斯基/
Alekseevskii	/阿列克谢耶夫斯基/
Aleksei	/阿列克谢/
Aleksej	/阿列克谢/
Aleksejeff	/阿列克谢耶夫/
Aleksejev	/阿列克谢耶夫/
Aleksendr	/亚历山大/
Aleksendric	/阿列克森德里奇/
Aleksenko	/阿列克先科/
Aleksenov	/阿列克谢诺夫/
Aleksenski	/阿列克先斯基/
Aleksensky	/阿列克先斯基/
Aleksentsev	/阿列克先采夫/
Alekserzade	/阿列克谢尔扎德/
Aleksey	/阿列克谢/
Alekseyenko	/阿列克谢延科/
Alekseyev	/阿列克谢耶夫/
Alekseyeva	/阿列克谢耶娃/
Alekseyevski	/阿列克谢耶夫斯基/
Alekseyevsky	/阿列克谢耶夫斯基/
Alekshin	/阿克列克申/
Aleksi	/阿列克西/
Aleksic	/阿列克西克/阿列克西奇/
Aleksich	/阿列克西奇/
Aleksidze	/阿列克西泽/
Aleksievicz	/阿莱克谢维奇/
Aleksievski	/阿列克西耶夫斯基/
Aleksii	/阿列克西/
Aleksij	/阿列克西/
Aleksija	/阿列克西娅/
Aleksije	/阿列克西耶/
Aleksijev	/阿列克西耶夫/
Aleksijevic	/阿列克西耶维奇/
Aleksijevski	/阿列克西耶夫斯基/
Aleksin	/阿列克辛/
Aleksina	/阿列克辛娜/亚历克西娜/
Aleksinski	/阿列克辛斯基/
Aleksinsky	/阿列克辛斯基/
Aleksis	/阿列克西斯/
Alekso	/阿列克索/
Aleksopolski	/阿列克索波利斯基/
Aleksopolsky	/阿列克索波利斯基/
Aleksopulo	/阿列克索普洛/
Aleksoski	/阿列克索斯基/
Aleksov	/阿列克索夫/
Aleksova	/阿列克索娃/
Aleksovski	/阿列克索夫斯基/
Aleksyev	/阿列克西耶夫/
Aleksyuk	/阿列克修克/
Aleksyutovich	/阿列克休托维奇/
Aleksza	/奥莱克绍/
Alekszi	/奥莱克西/
Alekulovich	/阿列库洛维奇/
Alekyan	/阿列基扬/
Alelekov	/阿列列科夫/
Alelfi	/阿莱勒菲/
Alelu	/阿莱卢/
Aleluia	/阿莱卢亚/
Alelyukhin	/阿列柳欣/
Alem	/阿莱姆/阿利姆/阿伦/
Alema	/阿莱马/
Aleman	/阿莱曼/
Alemani	/阿莱马尼/
Alemann	/阿莱曼/阿勒曼/
Alemanni	/阿莱曼尼/
Alemanno	/阿莱马诺/
Alemant	/阿勒芒/
Alemany	/阿莱马尼/阿勒马尼/
Alemao	/阿莱芒/
Alemayehu	/阿莱马耶胡/
Alembert	/阿朗贝尔/
Alembik	/阿朗比克/
Alemdag	/阿莱姆达/
Alemdar	/阿莱姆达尔/
Alemdaroglu	/阿莱姆达尔奥卢/
Alemdarsoy	/阿莱姆达尔索伊/
Alemite	/阿勒米特/
Alemparte	/阿伦帕特/
Alempic	/阿伦皮奇/
Alempija	/阿伦皮亚/
Alempije	/阿伦皮耶/
Alempijevic	/阿伦皮耶维奇/
Alemps	/阿朗/
Alemshakh	/阿列姆沙赫/
Alemu	/阿莱穆/
Alemy	/阿勒米/
Alemyehou	/阿莱米耶胡/
Alen	/阿朗/阿连/阿伦/
Alena	/阿莱娜/阿莱纳/阿廖娜/
Alenander	/阿莱南德/
Alenar	/阿莱尼亚尔/
Alenbo	/阿伦博/
Alenbring	/阿伦布林/
Alenby	/阿伦比/
Alencar	/阿伦卡尔/
Alencastre	/阿伦卡斯特雷/
Alencastro	/阿伦卡斯特罗/
Alencon	/阿朗松/
Alenda	/阿伦达/
Alendar	/阿伦达尔/
Alendarevic	/阿伦达雷维奇/
Alende	/阿伦德/
Alene	/阿莱内/艾琳/
Aleneff	/阿莱内夫/
Alenfalk	/阿伦法尔克/
Alenfelder	/阿伦费尔德/
Alengry	/阿朗格里/
Alenheim	/阿伦海姆/
Aleni	/阿莱尼/
Alenich	/阿列尼奇/
Alenichev	/阿列尼切夫/
Aleniewski	/阿莱涅夫斯基/
Alenin	/阿列宁/
Alenitsyn	/阿列尼岑/
Alenius	/阿莱纽斯/
Alenka	/阿伦卡/
Alenkin	/阿连金/
Alenlid	/阿伦利德/
Alenlov	/阿伦勒夫/
Alenmalm	/阿伦马尔姆/
Alenmark	/阿伦马克/
Alenov	/阿列诺夫/
Alenova	/阿列诺娃/
Alenpija	/阿伦皮亚/
Alenpije	/阿伦皮耶/
Alenquer	/阿伦克尔/
Alenrud	/阿伦鲁德/
Alenskog	/阿伦斯科格/
Alentado	/阿伦塔多/
Alentejano	/阿伦特雅诺/
Alentyev	/阿连季耶夫/
Aleokol	/阿莱奥科尔/
Aleon	/阿莱昂/
Aleonard	/阿莱奥纳尔/
Alepee	/阿莱佩/
Aleppski	/阿列普斯基/
Aleppsky	/阿列普斯基/
Aler	/阿莱尔/阿勒/
Aleramo	/阿莱拉莫/
Alered	/阿莱雷德/阿利雷德/
Alerfeldt	/阿勒费尔特/
Alergant	/阿莱尔冈/
Alergia	/阿莱尔希亚/
Alergic	/阿莱尔吉奇/
Alerheim	/阿勒海姆/
Aleric	/阿莱里奇/阿勒里克/
Alerius	/阿莱留斯/
Alerm	/阿莱姆/
Alero	/阿莱罗/
Alerot	/阿莱罗特/
Alers	/阿莱尔/阿勒斯/
Alersjo	/阿勒舍/
Alert	/阿莱尔特/
Alerto	/阿莱尔托/
Alerud	/阿莱鲁德/
Alervo	/阿莱尔沃/
Ales	/阿莱什/阿莱斯/奥莱什/
Alesa	/阿莱萨/
Alesana	/阿莱萨纳/
Alesanco	/阿莱桑科/
Alesandri	/亚历山德里/
Alesandrini	/亚历山德里尼/
Alesandru	/亚历山德鲁/
Alesci	/阿莱西/阿莱希/
Alesha	/阿廖沙/
Aleshin	/阿廖申/
Aleshinloye	/阿莱欣洛耶/
Aleshinski	/阿列申斯基/
Aleshinsky	/阿列申斯基/
Aleshire	/阿利希尔/
Aleshkin	/阿列什金/
Aleshko	/阿廖什科/
Aleshkov	/阿廖什科夫/
Aleshov	/阿列绍夫/
Alesi	/阿莱西/
Alesia	/阿莱西亚/
Alesin	/阿列辛/
Alesincu	/阿莱欣库/
Alesiu	/阿莱休/
Alesker	/阿列斯克尔/
Aleskerov	/阿列斯克罗夫/
Aleskerovich	/阿列斯克罗维奇/
Aleskovski	/阿列斯科夫斯基/
Aleskovsky	/阿列斯科夫斯基/
Aleson	/阿莱松/
Alesova	/阿莱绍娃/
Alespa	/阿莱斯帕/
Alespong	/阿莱斯蓬/
Alessandra	/亚历山德拉/
Alessandrelli	/亚历山德雷利/
Alessandrescu	/亚历山德雷斯库/
Alessandri	/亚历山德里/
Alessandria	/亚历山德里亚/
Alessandrini	/亚历山德里尼/
Alessandriu	/亚历山德留/
Alessandro	/亚历山德罗/
Alessandroni	/亚历山德罗尼/
Alesseanu	/阿莱塞亚努/
Alessi	/阿莱西/
Alessio	/阿莱西奥/
Alessis	/阿莱西/
Alessiu	/阿莱休/
Alestalo	/阿莱斯塔洛/
Alestedt	/阿莱斯泰特/
Alester	/阿莱斯特/
Alestrom	/阿莱斯特伦/
Alestruey	/阿莱斯特鲁埃/
Alesund	/奥勒松/
Alesved	/阿莱斯韦德/
Alet	/阿莱/
Aleth	/阿勒特/
Aletha	/阿莱莎/
Alethorpe	/埃尔索普/
Aleti	/阿列季/
Aletic	/阿莱蒂奇/
Aletorn	/阿莱托恩/
Aletsee	/阿勒策/
Aletta	/阿莱塔/
Alette	/阿莱特/
Alety	/阿列季/
Alev	/阿莱夫/
Aleva	/奥莱沃/
Alevcan	/阿莱夫詹/
Aleveque	/阿莱韦克/
Alevey	/阿利维/
Alevitto	/阿莱维托/
Alevizos	/阿莱维佐斯/
Alevli	/阿莱夫利/
Alevra	/阿莱夫拉/
Alevras	/阿莱夫拉斯/
Alevtin	/阿列夫京/
Alevtina	/阿列夫京娜/
Alewa	/阿莱瓦/
Alewell	/阿勒韦尔/
Alewine	/阿莱温/
Alewyn	/阿勒温/
Alex	/阿莱士/亚历克斯/
Alexa	/阿列克萨/亚历克萨/
Alexakis	/亚历克萨基斯/
Alexan	/阿列克桑/
Alexanco	/亚历山科/
Alexander	/亚历山大/
Alexanderson	/亚历山大松/亚历山德森/
Alexandersson	/亚历山大松/
Alexandescu	/亚历山德斯库/
Alexandovna	/亚历山德罗芙娜/
Alexandr	/亚历山大/
Alexandra	/亚历山德拉/
Alexandrakis	/亚历山德拉基斯/
Alexandras	/亚历山德拉斯/
Alexandratos	/亚历山德拉托斯/
Alexandre	/亚历山大/
Alexandreanu	/亚历山德雷亚努/
Alexandrenne	/亚历山德雷内/
Alexandres	/亚历山德雷斯/
Alexandrescu	/亚历山德雷斯库/
Alexandri	/亚历山德里/
Alexandria	/亚历山德里亚/
Alexandrian	/亚历山德里昂/
Alexandridis	/亚历山德里迪斯/
Alexandrii	/亚历山德里/
Alexandrina	/亚历山德里娜/
Alexandrine	/亚历山德里娜/
Alexandrini	/亚历山德里尼/
Alexandrino	/亚历山德里诺/
Alexandris	/亚历山德里/亚历山德里斯/
Alexandriu	/亚历山德留/
Alexandriuc	/亚历山德留克/
Alexandro	/亚历山德罗/
Alexandroae	/亚历山德罗阿耶/
Alexandroaie	/亚历山德罗阿耶/
Alexandroff	/亚历山德罗夫/
Alexandropoulos	/亚历山德罗普洛斯/
Alexandros	/亚历山德罗斯/
Alexandrov	/亚历山德罗夫/
Alexandrova	/亚历山德罗娃/
Alexandrovich	/亚历山德罗维奇/
Alexandrovicova	/亚历山德罗维乔娃/
Alexandrovitch	/亚历山德罗维奇/
Alexandrovna	/亚历山德罗芙娜/
Alexandrowitz	/亚历山德罗维茨/
Alexandru	/亚历山德鲁/
Alexandry	/亚历山德里/
Alexanian	/亚历克萨尼昂/
Alexanyan	/阿列克萨尼扬/
Alexashenko	/阿列克萨申科/
Alexbank	/亚历克斯班克/
Alexbert	/亚历克斯贝尔/
Alexe	/阿列克谢/
Alexeev	/阿莱克谢耶夫/
Alexeevsky	/阿莱克谢耶夫斯基/
Alexei	/阿列克谢/
Alexeieff	/阿列克谢耶夫/
Alexeiev	/阿列克谢耶夫/
Alexeievich	/阿列克谢耶维奇/
Alexeievna	/阿列克谢耶芙娜/
Alexejeva	/阿列克谢耶娃/
Alexejova	/阿列克谢约娃/
Alexeline	/亚历克瑟利娜/
Alexen	/亚历克森/
Alexenco	/阿列克森科/
Alexendre	/亚历山大/
Alexescu	/阿列克塞斯库/
Alexeviciz	/阿列克塞维奇兹/
Alexey	/阿列克谢/
Alexeyevich	/阿列克谢耶维奇/
Alexi	/阿列克西/亚历克西/
Alexia	/亚历克西娅/
Alexiade	/亚历克西亚德/
Alexiades	/亚历克西亚代斯/亚历克西亚德斯/亚历克西亚季斯/
Alexiadis	/亚历克西亚季斯/
Alexian	/阿列克西安/
Alexianu	/阿列克夏努/
Alexics	/亚历克西奇/
Alexie	/阿列克谢/亚历克西/
Alexiev	/阿列克谢耶夫/
Alexievova	/阿列克谢沃娃/
Alexij	/阿列克西/
Alexin	/阿列克辛/
Alexina	/阿莱希娜/
Alexine	/亚历克西娜/
Alexinio	/阿莱希尼奥/
Alexios	/阿莱希奥斯/
Alexiou	/亚历克西乌/
Alexis	/亚历克西/亚历克西斯/
Alexisson	/亚历克西森/亚历克西松/
Alexits	/亚历克西茨/
Alexiu	/阿列克休/
Alexiuc	/阿列克西乌克/
Alexius	/亚历克修斯/
Alexnat	/亚历克斯纳特/
Alexoaie	/阿列克索阿耶/
Alexoiu	/阿列克索尤/
Alexopoulos	/亚历克索普洛斯/
Alexos	/亚历克索斯/
Alexov	/阿列克索夫/
Alexova	/阿列克索娃/
Alexovics	/亚历克索维奇/
Alexuta	/阿列克苏策/
Alexy	/阿列克西/亚历克西/
Alexys	/亚历克西/
Aley	/阿利/
Aleyaume	/阿莱奥姆/
Aleyev	/阿列耶夫/
Aleyn	/阿林/
Aleyon	/阿莱永/
Aleyrac	/阿莱拉克/
Alezard	/阿勒扎尔/
Aleziev	/阿列齐耶夫/
Alezra	/阿莱兹拉/
Alezraqui	/阿莱斯拉基/
Alf	/阿尔夫/
Alfa	/阿尔法/阿勒法/
Alface	/阿尔法塞/
Alfacinha	/阿尔法西尼亚/
Alfageme	/阿尔法赫梅/
Alfagene	/阿尔法赫内/
Alfaia	/阿尔法亚/
Alfaiataria	/阿尔法亚塔里亚/
Alfaiate	/阿尔法亚特/
Alfalk	/阿尔法尔克/
Alfama	/阿尔法马/
Alfambra	/阿尔凡布拉/
Alfan	/阿尔方/
Alfandari	/阿尔方达里/
Alfandary	/阿尔方达里/
Alfandery	/阿尔方代里/
Alfange	/阿尔芬奇/
Alfano	/阿尔法诺/
Alfar	/阿尔法/
Alfara	/阿尔法拉/
Alfaraz	/阿尔法拉斯/
Alfare	/阿尔法尔/
Alfarela	/阿尔法雷拉/
Alfarelos	/阿尔法雷洛斯/
Alfares	/阿尔法雷斯/
Alfaric	/阿尔法里克/
Alfarma	/阿尔法马/
Alfaro	/阿尔法罗/
Alfarra	/阿尔法拉/
Alfarroba	/阿尔法罗巴/
Alfarrobinha	/阿尔法罗比尼亚/
Alfassa	/阿尔法萨/
Alfaya	/阿尔法亚/
Alfayate	/阿尔法亚特/
Alfayo	/阿尔法约/
Alfbo	/阿尔夫博/
Alfe	/阿尔弗/
Alfedi	/阿尔费迪/
Alfei	/阿尔费/
Alfeirao	/阿尔费朗/
Alfela	/阿尔费拉/
Alfeld	/阿尔费尔德/
Alfelt	/阿尔费尔特/
Alfen	/阿尔芬/
Alfena	/阿尔费纳/
Alfeo	/阿尔费奥/
Alfer	/阿尔费/阿尔费奥尔/
Alferaki	/阿尔费拉基/
Alferes	/阿尔费雷斯/
Alferez	/阿尔费雷斯/
Alferi	/阿尔费里/
Alferieff	/阿尔费列夫/
Alferiova	/阿尔费里奥娃/
Alferov	/阿尔费罗夫/
Alfersa	/阿尔费萨/
Alfert	/阿尔费/阿尔费特/
Alfery	/阿尔费里/
Alferyev	/阿尔费里耶夫/
Alferyova	/阿尔费里奥娃/
Alfes	/阿尔费斯/
Alfete	/阿尔费特/
Alfeu	/阿尔费乌/
Alfeyev	/阿尔费耶夫/
Alfeyo	/阿尔费约/
Alff	/阿尔夫/
Alfheim	/阿尔夫海姆/
Alfhild	/阿尔夫希尔/阿尔夫希尔德/
Alfi	/阿尔菲/阿勒菲/
Alficher	/阿尔菲谢/
Alfidja	/阿勒菲贾/
Alfieri	/阿尔菲里/阿尔菲耶里/
Alfii	/阿尔菲/
Alfil	/阿尔菲尔/
Alfille	/阿尔菲耶/
Alfimo	/阿尔菲莫/
Alfimov	/阿尔菲莫夫/
Alfimtsev	/阿尔菲姆采夫/
Alfin	/阿尔芬/
Alfina	/阿尔菲纳/
Alfinete	/阿尔菲内特/
Alfio	/阿尔菲奥/
Alfirev	/阿尔菲雷夫/
Alfirevic	/阿尔菲雷维奇/
Alfiri	/阿尔菲里/
Alfirovic	/阿尔菲罗维奇/
Alfiya	/阿尔菲娅/
Alfled	/埃尔夫勒德/
Alfloarei	/阿尔弗洛阿雷伊/
Alfoldi	/奥尔弗尔迪/
Alfoldv	/阿尔弗尔德夫/
Alfoldy	/阿尔弗尔迪/奥尔弗尔迪/
Alfon	/阿尔方/
Alfonas	/阿尔福纳斯/
Alfonce	/阿尔丰斯/
Alfons	/阿尔方斯/阿方斯/
Alfonsas	/阿尔方萨斯/
Alfonse	/阿方斯/
Alfonseca	/阿方塞卡/
Alfonsi	/阿方西/
Alfonsin	/阿方辛/
Alfonsina	/阿方西娜/
Alfonsius	/阿方修斯/
Alfonski	/阿尔方斯基/
Alfonsky	/阿尔方斯基/
Alfonso	/阿方索/
Alfonson	/阿尔方松/
Alfonsovich	/阿尔方索维奇/
Alfonzo	/阿方索/
Alford	/阿尔福/阿尔福德/奥尔福德/
Alforn	/阿尔福恩/
Alfors	/阿尔福什/
Alfranca	/阿尔弗兰卡/
Alfrao	/阿尔弗拉奥/
Alfre	/阿尔弗雷/
Alfred	/阿尔弗雷德/阿尔弗雷兹/艾尔弗雷德/奥尔弗雷德/
Alfredeen	/阿尔弗雷登/
Alfredine	/阿尔弗雷迪娜/
Alfredius	/阿尔弗雷迪乌斯/
Alfredo	/阿尔弗雷多/
Alfredovich	/阿尔弗雷多维奇/
Alfreds	/阿尔弗雷斯/阿尔弗雷兹/
Alfredson	/阿尔弗雷德松/
Alfredsson	/阿尔弗雷德松/
Alfreton	/奥尔弗里顿/
Alfrida	/阿尔弗里达/
Alfriend	/阿尔弗林德/
Alfriston	/奥尔弗里斯顿/
Alfroy	/阿尔弗鲁瓦/
Alfsen	/阿尔夫桑/
Alfsson	/阿尔夫松/
Alfstrom	/阿尔夫斯特伦/
Alftan	/阿尔夫坦/
Alftberg	/阿尔夫特贝里/
Alfter	/阿尔夫特/
Alfthan	/阿尔夫坦/
Alftner	/阿尔夫特纳/
Alfultis	/阿尔富蒂斯/
Alfuss	/阿尔富斯/
Alfvegren	/阿尔韦格伦/
Alfven	/阿尔文/
Alfvin	/阿尔温/
Alfy	/阿尔菲/阿勒菲/
Alfyor	/阿尔费奥尔/
Alga	/阿尔加/
Algaba	/阿尔加瓦/
Algacs	/奥尔加奇/
Algadil	/阿尔加迪尔/
Algan	/阿尔甘/阿尔冈/
Alganatay	/阿尔加纳塔伊/
Alganci	/阿尔甘哲/
Alganer	/阿尔加内尔/
Algani	/阿尔加尼/
Alganius	/阿尔加纽斯/
Algans	/阿尔甘斯/
Algar	/阿尔格/阿尔加尔/
Algarabel	/阿尔加拉韦尔/
Algarada	/阿尔加拉达/
Algaradel	/阿尔加拉德尔/
Algarate	/阿尔加拉特/
Algaraz	/阿尔加拉斯/
Algard	/阿尔高/阿尔加/奥尔高/
Algarde	/阿尔格德/
Algardi	/阿尔加迪/
Algares	/阿尔加雷斯/
Algarin	/阿尔加林/
Algarkirk	/奥尔格柯克/
Algarotti	/阿尔加罗蒂/
Algarra	/阿尔加拉/
Algarrada	/阿尔加拉达/
Algarron	/阿尔加龙/
Algarve	/阿尔加韦/
Algarvio	/阿尔加维奥/
Algase	/阿尔加斯/
Algaud	/阿尔戈/
Algava	/阿尔加瓦/
Algavi	/阿尔加维/
Algaze	/阿尔加兹/
Algazi	/阿尔加齐/
Algazin	/阿尔加津/
Algazy	/阿尔加齐/
Algberg	/阿尔格贝里/
Alge	/阿尔格/阿尔热/
Algeciras	/阿尔赫西拉斯/
Algelin	/阿尔格林/
Algemiro	/阿尔热米罗/
Alger	/阿尔杰/阿尔热/
Algera	/阿尔赫拉/
Algerao	/阿尔热朗/
Algerie	/阿尔赫列/阿尔热里/
Algermissen	/阿尔格米森/
Algern	/阿尔杰恩/
Algernon	/阿尔格农/阿尔赫农/阿尔杰农/阿尔热农/
Algero	/阿尔赫罗/
Algeroth	/阿尔格罗特/
Algers	/阿尔格斯/
Algerud	/阿尔格鲁德/
Algesjo	/阿尔格舍/
Algeso	/阿尔热索/
Algeson	/阿尔格松/
Algesten	/阿尔格斯滕/
Algete	/阿尔赫特/
Algeus	/阿尔格乌斯/
Alghabid	/阿比德/
Algiber	/阿尔希韦尔/
Algibez	/阿尔希韦斯/
Algie	/阿尔吉/
Algier	/阿尔格埃尔/阿尔吉耶/
Algieri	/阿尔吉里/
Algimantas	/阿尔吉曼塔斯/
Algin	/阿尔根/
Algirdas	/阿尔吉尔达斯/
Algis	/阿尔吉/阿尔吉斯/
Algiu	/阿尔久/
Algiyawanna	/阿尔吉亚万纳/
Alglave	/阿尔格拉夫/
Algo	/阿尔戈/
Algobar	/阿尔戈瓦尔/
Algobia	/阿尔戈维亚/
Algodoal	/阿尔戈杜瓦尔/
Algodres	/阿尔戈德雷斯/
Algoma	/阿尔戈马/
Algon	/阿尔贡/
Algora	/阿尔戈拉/
Algorette	/阿尔戈雷特/
Algoria	/阿尔戈里亚/
Algot	/阿尔戈特/
Algothson	/阿尔戈特松/
Algotson	/阿尔戈特松/
Algotsson	/阿尔戈特松/
Algott	/阿尔戈特/
Algotzon	/阿尔戈特松/
Algoud	/阿尔古/
Algover	/奥尔格韦尔/
Algovia	/阿尔戈维亚/
Algovik	/阿尔戈维克/
Algoza	/阿尔戈萨/
Algra	/阿尔格拉/
Algrain	/阿尔格兰/
Algranate	/阿尔格拉纳特/
Algre	/阿尔格雷/
Algren	/阿尔格伦/
Algret	/阿尔格雷/
Algrin	/阿尔格兰/
Algrot	/阿尔格罗特/
Algrund	/阿尔格伦德/
Algsjo	/阿尔格舍/
Algstedt	/阿尔格斯泰特/
Alguacil	/阿尔瓜西尔/
Alguer	/阿尔格尔/
Alguero	/阿尔格罗/
Algueza	/阿尔格萨/
Algugaray	/阿尔古加赖/
Alguijo	/阿尔吉霍/
Algul	/阿尔居尔/
Algulin	/阿尔古林/
Algun	/阿尔贡/阿尔金/
Alguner	/阿尔居内尔/
Algvere	/阿尔格韦勒/
Algyay	/阿尔焦伊/
Alha	/阿尔哈/
Alhabo	/阿拉博/
Alhadef	/阿拉代夫/
Alhadeff	/阿尔哈德夫/
Alhadeve	/阿拉代夫/
Alhadj	/哈吉/
Alhainen	/阿尔海宁/
Alhajarvi	/阿尔哈耶尔维/
Alhaji	/哈吉/
Alhale	/阿拉勒/
Alhalel	/阿尔哈莱尔/
Alhaleli	/阿尔哈莱利/
Alhalidi	/阿尔哈利迪/
Alhall	/阿尔哈尔/
Alhama	/阿利亚马/
Alhamas	/阿利亚马斯/
Alhambra	/阿兰布拉/
Alhamdou	/哈姆杜/
Alhan	/阿尔汗/
Alhanati	/阿拉纳蒂/
Alhandra	/阿良德拉/
Alhanen	/阿尔哈宁/
Alhanko	/阿尔汉科/
Alharakan	/哈拉坎/
Alhard	/阿尔哈德/
Alhas	/阿尔哈斯/
Alhasid	/阿尔哈西德/
Alhassan	/哈桑/
Alhava	/阿尔哈瓦/
Alhegyi	/奥尔海吉/
Alheim	/阿尔海姆/
Alheiro	/阿列罗/
Alhenc	/阿朗/
Alhendin	/阿连丁/
Alher	/阿列尔/
Alheritiere	/阿莱里蒂埃/
Alhinho	/阿利尼奥/
Alho	/阿尔霍/阿略/
Alhoff	/阿尔霍夫/
Alhojarvi	/阿尔霍耶尔维/
Alhojoki	/阿尔霍约基/
Alhokorpi	/阿尔霍科皮/
Alhola	/阿尔霍拉/
Alhomaki	/阿尔霍迈基/
Alhomme	/阿洛姆/
Alhondiga	/阿隆迪加/
Alhonen	/阿尔霍宁/
Alhonnoro	/阿尔洪诺罗/
Alhonoja	/阿尔霍诺亚/
Alhonsaari	/阿尔洪萨里/
Alhopuro	/阿尔霍普罗/
Alhor	/阿略尔/
Alhoranta	/阿尔霍兰塔/
Alhos	/阿尔霍斯/
Alhousseini	/侯赛尼/
Alhucemas	/阿卢塞马斯/
Alhvin	/阿尔温/
Ali	/阿里/阿利/奥利/
Ali-Rachedi	/阿里－拉希迪/
Ali-Zade	/阿里扎德/
Alia	/阿利雅/阿利亚/阿利娅/
Aliabadi	/阿里阿巴迪/
Aliadiere	/阿利亚迪埃/
Aliaga	/阿里阿加/
Aliagas	/阿利亚加/阿利亚加斯/
Aliam	/阿利亚姆/
Aliama	/阿利亚马/
Aliamer	/阿利亚梅/
Aliamet	/阿利亚梅/
Aliamovsky	/阿利亚莫夫斯基/
Aliamus	/阿利亚米/
Alianac	/阿利亚纳克/
Aliani	/阿利亚妮/
Aliano	/阿利亚尼奥/
Alianza	/阿利安萨/
Aliarcham	/阿利亚哈姆/
Aliarilla	/阿利亚里利亚/
Alias	/阿利亚/阿利亚斯/
Aliashraf	/阿里阿什拉夫/
Aliaskar	/阿里阿斯卡尔/
Aliasuren	/阿利亚苏伦/
Aliaume	/阿利奥姆/
Alibaba	/阿里巴巴/阿利瓦瓦/
Alibabic	/阿利巴比奇/
Alibala	/阿里巴拉/
Alibasoglu	/阿利巴什奥卢/
Alibaud	/阿利博/
Alibaux	/阿利博/
Alibegov	/阿利别戈夫/
Alibegovic	/阿利贝戈维奇/
Alibek	/阿利别克/
Alibekov	/阿利别科夫/
Alibelli	/阿利贝利/
Aliber	/阿利贝尔/阿利伯/
Aliberch	/阿利韦尔奇/
Alibert	/阿利贝尔/
Aliberti	/阿利贝蒂/阿利韦蒂/
Alibhoy	/阿利布伊/
Alibi	/阿利比/
Alibrando	/阿利布兰多/
Alibux	/阿利布克斯/
Alic	/阿勒奇/阿利奇/
Alicajic	/阿利查伊奇/阿利恰伊奇/
Alican	/阿利詹/
Alicante	/阿利坎特/
Alicart	/阿利卡特/
Alicarte	/阿利卡特/
Alicata	/阿利卡塔/
Alice	/阿莉塞/阿利塞/艾丽斯/
Alicerces	/阿利塞尔塞斯/
Alich	/阿利希/
Alici	/阿勒哲/
Alicia	/阿莉西亚/艾丽西亚/
Alicic	/阿利契奇/
Alicioglu	/阿勒哲奥卢/
Alicja	/阿莉恰/
Alicjajic	/阿利恰伊奇/
Alick	/阿利克/
Alickovic	/阿利奇科维奇/
Alicli	/阿勒奇勒/
Alico	/阿利科/
Alicot	/阿利科/
Alicsandrescu	/亚历山德雷斯库/
Alicsandru	/亚历山德鲁/
Alicu	/阿利库/
Aliczajic	/阿利查伊奇/
Aliczky	/奥利茨基/
Alida	/阿莉达/阿利达/
Alidavit	/阿利达维特/
Alidin	/阿利金/
Alidini	/阿利迪尼/
Alidius	/阿利迪厄斯/
Alido	/阿利多/
Alidou	/阿利杜/
Alidzhan	/阿利占/
Alie	/阿利耶/
Aliecer	/阿列塞尔/
Alieddin	/阿里丁/
Alien	/阿利安/
Aliena	/阿列纳/
Aliende	/阿连德/
Alienes	/阿列内斯/
Aliengin	/阿利恩金/
Alier	/阿列尔/埃利尔/
Alierta	/阿列尔塔/
Alies	/阿利/
Alieto	/阿列托/
Aliette	/阿利耶特/
Alieu	/阿利乌/
Aliev	/阿利耶夫/
Alieva	/阿列瓦/
Alievich	/阿利耶维奇/
Alievici	/阿列维奇/
Alieza	/阿里扎/
Alif	/阿利夫/
Alifa	/阿利法/
Alifanov	/阿里法诺夫/
Alifanti	/阿利凡蒂/
Alifantov	/阿利凡托夫/
Alife	/阿利费/
Alifei	/阿利费/
Aliferi	/阿利费里/
Aliferis	/阿利费里斯/
Alifet	/阿利费/
Alifonso	/阿利方索/
Aliga	/阿利加/
Aligard	/阿利加尔/
Aligas	/阿利加斯/
Aligeier	/阿利赫耶/
Aliger	/阿利格尔/
Alighieri	/阿利吉耶里/
Aligil	/阿利吉尔/
Aligirdas	/阿利吉尔达斯/
Alignol	/阿利尼奥尔/
Aligny	/阿利尼/
Aligon	/阿利贡/
Aligrudic	/阿利格鲁迪奇/
Aliguzhinov	/阿利古日诺夫/
Alihamed	/阿利亚梅德/
Alihamy	/阿利哈米/
Alihocagil	/阿利霍贾吉尔/
Alihodzic	/阿利霍季奇/
Aliiende	/阿连德/
Alija	/阿利哈/阿利雅/阿利亚/
Alijagic	/阿利亚吉奇/
Alijah	/阿利贾赫/
Alijarde	/阿利哈尔德/
Alijevic	/阿利耶维奇/
Aliji	/阿利吉/
Alijo	/阿利霍/
Alijoski	/阿利约斯基/
Alik	/阿利克/
Alikadic	/阿利卡迪奇/
Alikaj	/阿利卡伊/
Alikalfic	/阿利卡尔菲奇/
Alikalific	/阿利卡利菲奇/
Alikaya	/阿利卡亚/
Alikayev	/阿利卡耶夫/
Alikberov	/阿利克别罗夫/
Aliker	/阿利克/
Alikhadzhayev	/阿利哈贾耶夫/
Alikhan	/阿里汗/
Alikhanian	/阿利哈尼扬/
Alikhanov	/阿里汗诺夫/
Alikhanyan	/阿利哈尼扬/
Alikhashkin	/阿利哈什金/
Alikhodzhin	/阿利霍金/
Alikian	/阿利基昂/
Alikin	/阿利金/
Alikisioglu	/阿利基希奥卢/
Aliklc	/阿利克尔奇/
Aliko	/阿利科/
Alikoff	/阿利科夫/
Alikov	/阿利科夫/
Alil	/阿利尔/阿利勒/
Alilaire	/阿利莱尔/
Alili	/阿利利/
Alilomov	/阿利洛莫夫/
Aliloski	/阿利洛斯基/
Alilovic	/阿利洛维奇/
Aliluyev	/阿利卢耶夫/
Alim	/阿勒姆/阿利姆/
Alima	/阿利马/
Alimadi	/阿利马迪/
Alimahiroglu	/阿利马希尔奥卢/
Alimamay	/阿利马米/
Alimamed	/阿利马梅德/
Alimami	/阿利马米/
Alimamy	/阿利马米/
Aliman	/阿利曼/
Alimanescu	/阿利默内斯库/
Alimanesteanu	/阿利马内什泰亚努/
Alimanovic	/阿利马诺维奇/
Alimany	/阿利马尼/
Alimarin	/阿利马林/
Alimata	/阿利马塔/
Alimbayev	/阿林巴耶夫/
Alimbek	/阿林别克/
Alimbetov	/阿林别托夫/
Alimdzhan	/阿利姆占/
Alimdzhanov	/阿利姆扎诺夫/
Alimen	/阿利芒/
Alimerko	/阿利梅科/
Alimi	/阿利米/
Alimkhanov	/阿利姆哈诺夫/
Alimkin	/阿利姆金/
Alimli	/阿勒姆勒/
Alimonda	/阿利蒙达/
Alimonier	/阿利莫尼耶/
Alimorian	/阿利莫里安/
Alimov	/阿利莫夫/
Alimova	/阿利莫娃/
Alimovic	/阿利莫维奇/
Alimovich	/阿利莫维奇/
Alimpic	/阿林皮奇/
Alimpija	/阿林皮亚/
Alimpijada	/阿林皮娅达/
Alimpije	/阿林皮耶/
Alimpijevic	/阿林皮耶维奇/
Alimpiyev	/阿林皮耶夫/
Alimuddin	/阿利姆丁/
Alimzhanov	/阿利姆扎诺夫/
Alimzhanovich	/阿利姆扎诺维奇/
Alin	/阿林/
Alina	/阿林娜/
Alinak	/阿勒纳克/
Alinbay	/阿伦巴伊/
Alinc	/阿兰/阿伦奇/
Alincahan	/阿伦贾汗/
Alincak	/阿伦贾克/
Alince	/阿林切/
Alincic	/阿林契奇/
Alinda	/阿林达/
Alinder	/阿林德/
Alindret	/阿兰德雷/
Aline	/阿林/艾琳/
Alinen	/阿利宁/
Alinescu	/阿利内斯库/
Aling	/阿林/
Alinga	/阿林加/
Alingborg	/阿林堡/
Alinge	/阿林格/
Alingrin	/阿兰格兰/
Alingsjo	/阿林舍/
Alington	/阿林顿/
Alingue	/阿林格/
Alinikula	/阿利尼库拉/
Alinka	/阿琳卡/
Alinmiser	/阿伦默谢尔/
Alino	/阿利尼奥/
Alinoti	/阿利诺蒂/
Alinov	/阿利诺夫/
Alinovi	/阿利诺维/
Alins	/阿林斯/
Alinsky	/阿林斯基/
Alinte	/阿林特/
Alinteri	/阿伦泰里/
Alio	/阿利奥/
Aliod	/阿利奥德/
Alioglu	/阿里奥卢/
Aliomar	/阿里奥马尔/
Alion	/阿利翁/
Alionte	/阿利翁特/
Alios	/阿利奥/
Alioski	/阿利奥斯基/
Aliot	/阿利奥/阿利奥特/
Aliote	/阿利奥特/
Alioto	/阿利奥托/
Aliotti	/阿利奥蒂/
Aliou	/阿利乌/
Alioua	/阿勒万/
Aliouan	/阿勒万/
Aliouche	/阿利乌什/
Alioun	/阿利翁/
Alioune	/阿利翁/
Aliova	/阿利奥娃/
Aliovsad	/阿利奥夫萨德/
Aliovsat	/阿利奥夫萨特/
Alip	/阿利普/
Alipanov	/阿利帕诺夫/
Alipasha	/阿里帕夏/
Alipate	/阿利帕特/
Alipaz	/阿利帕斯/
Aliperti	/阿利佩蒂/
Alipi	/阿利皮/
Alipii	/阿利皮/
Alipio	/阿利皮奥/
Alipiyev	/阿利皮耶夫/
Alipov	/阿利波夫/
Aliprandi	/阿利普兰迪/
Alipui	/阿利普伊/
Alique	/阿利克/
Aliquot	/阿利科/
Alirangues	/阿利兰格斯/
Alireza	/阿里－礼萨/
Aliri	/阿利里/
Alirio	/阿利里奥/
Alirkan	/阿勒尔坎/
Aliro	/阿利罗/
Alirol	/阿利罗尔/
Alirsatar	/阿勒尔萨塔尔/
Alis	/阿勒什/阿利/阿利斯/
Alisa	/阿莉萨/阿利萨/
Alisaab	/阿里萨阿卜/
Alisalo	/阿利萨洛/
Alisan	/阿利尚/
Alisandru	/阿利桑德鲁/
Alisani	/阿利沙尼/
Alisbah	/阿利斯巴赫/
Alisch	/阿利施/
Alisdair	/阿利斯代尔/
Aliseda	/阿利塞达/
Alisedo	/阿利塞多/
Alisen	/阿利森/
Aliseris	/阿利塞里斯/
Alises	/阿利塞斯/
Alish	/阿利什/
Alishan	/阿利尚/
Alishauskaite	/阿利绍斯凯捷/
Alishauskas	/阿利绍斯卡斯/
Alisher	/阿利舍尔/
Alisipahi	/阿利西帕希/
Alisiroglu	/阿利希尔奥卢/
Alisoltan	/阿里苏丹/
Alison	/阿利松/艾莉森/
Alisov	/阿利索夫/
Alispahic	/阿利斯帕希奇/
Alissa	/阿利萨/
Alissandre	/亚历山大/
Alisse	/阿利斯/
Alistair	/阿利斯泰尔/
Alistar	/阿利斯塔尔/
Aliste	/阿利斯特/
Alister	/阿利斯特/
Alisto	/阿利斯托/
Alistrada	/阿利斯特拉达/
Alit	/阿利特/
Alitalo	/阿利塔洛/
Alitan	/阿利坦/
Alite	/阿利特/
Alithonou	/阿利托努/
Alitovic	/阿利托维奇/
Alitupa	/阿利图帕/
Aliu	/阿利乌/
Aliune	/阿利翁/
Alius	/阿利于斯/阿柳斯/
Aliuska	/阿柳斯卡/
Alivera	/阿莉韦拉/阿利韦拉/
Aliverdiev	/阿利韦尔季耶夫/
Aliveren	/阿勒韦伦/
Alivesi	/阿利韦西/
Alivezache	/阿利韦扎凯/
Alivin	/阿利文/
Alivodic	/阿利沃迪奇/
Alivon	/阿利翁/
Alivuk	/阿利武克/
Alix	/阿利克斯/
Alixe	/阿利克斯/
Aliyar	/阿利亚尔/
Aliyarov	/阿利亚罗夫/
Aliye	/阿利耶/
Aliyeh	/阿利耶/
Aliyev	/阿利耶夫/
Aliyevich	/阿利耶维奇/
Aliyevski	/阿利耶夫斯基/
Aliyevsky	/阿利耶夫斯基/
Aliyorov	/阿利约罗夫/
Aliyow	/阿利尤/
Aliyu	/阿利尤/
Aliz	/阿利斯/阿利泽/
Aliza	/阿莉扎/阿利扎/
Alizadeh	/阿里扎德/
Alizai	/阿里扎伊/
Alizard	/阿利扎尔/
Alizart	/阿利扎尔/
Alize	/阿利兹/
Aliziambina	/阿利齐安比纳/
Alizon	/阿利松/阿利宗/
Alizoti	/阿利佐蒂/
Alja	/阿尔雅/
Aljac	/阿尔雅克/
Aljama	/阿尔哈马/
Aljancic	/阿连契奇/
Aljane	/阿尔雅纳/
Aljarilla	/阿尔哈里利亚/
Aljaz	/贾兹/
Aljidini	/阿利迪尼/
Aljilji	/阿利利/
Aljinovic	/阿利诺维奇/
Aljiti	/阿利蒂/
Aljovic	/阿廖维奇/
Aljovin	/阿尔霍温/
Aljusevski	/阿柳舍夫斯基/
Aljusi	/阿柳希/
Aljustrel	/阿尔茹斯特雷尔/
Alka	/阿尔卡/
Alkadarski	/阿尔卡达尔斯基/
Alkadarsky	/阿尔卡达尔斯基/
Alkadyev	/阿尔卡季耶夫/
Alkalaj	/阿尔卡拉伊/
Alkali	/阿尔卡利/
Alkalj	/阿尔卡利/
Alkaly	/阿勒卡利/
Alkamper	/阿尔肯佩尔/
Alkan	/阿尔坎/
Alkapar	/阿尔卡帕尔/
Alkar	/阿尔卡尔/
Alkara	/阿尔卡拉/
Alkas	/阿尔卡什/
Alkatiri	/阿尔卡蒂里/
Alkaya	/阿尔卡亚/
Alkblad	/阿尔克布拉德/
Alkbo	/阿尔克博/
Alkborough	/奥尔克伯勒/
Alke	/阿尔克/
Alkebo	/阿尔克博/
Alkeborn	/阿尔克博恩/
Alkebring	/阿尔克布林/
Alkeby	/阿尔克比/
Alkelaj	/阿尔凯拉伊/
Alkelid	/阿尔克利德/
Alkell	/阿尔克尔/
Alkema	/阿尔克马/
Alkemyr	/阿尔克米/
Alken	/阿尔肯/
Alkenberg	/阿尔肯贝里/
Alkenbrecher	/阿尔肯布雷歇/
Alker	/阿尔克/奥尔凯尔/
Alkered	/阿尔克雷德/
Alkerstedt	/阿尔克斯泰特/
Alkeryd	/阿尔克吕德/
Alkesjo	/阿尔克舍/
Alkestam	/阿尔克斯坦/
Alkestig	/阿尔克斯蒂格/
Alketott	/阿尔克托特/
Alkevik	/阿尔克维克/
Alkfors	/阿尔克福什/
Alkgard	/阿尔克高/
Alkhairovich	/阿尔海罗维奇/
Alkham	/奥尔克姆/
Alkhammar	/阿尔克哈马尔/
Alkhatim	/哈特姆/
Alkhazov	/阿尔哈佐夫/
Alkhimov	/阿尔希莫夫/
Alkhovski	/阿尔霍夫斯基/
Alkhovsky	/阿尔霍夫斯基/
Alkia	/阿尔基亚/
Alkibay	/阿尔基巴伊/
Alkibijad	/阿尔基比亚德/
Alkier	/阿尔凯尔/
Alkiewicz	/阿尔凯维奇/
Alkija	/阿拉基贾/
Alkil	/阿尔基尔/
Alkilic	/阿尔克勒奇/
Alkim	/阿尔基姆/阿尔克姆/
Alkin	/阿尔肯/
Alkindar	/阿尔金达尔/阿尔肯达尔/
Alkington	/奥尔金顿/
Alkio	/阿尔基奥/
Alkis	/阿尔基斯/阿尔克什/
Alkiviad	/阿尔基维阿德/
Alkki	/阿尔基/
Alkkiomaki	/阿尔基奥迈基/
Alkman	/阿尔克曼/
Alkmar	/阿尔克马尔/
Alkmena	/阿尔克梅娜/
Alkmin	/阿尔克明/
Alko	/阿尔科/
Alkoc	/阿尔科奇/
Alkor	/阿尔科尔/
Alkos	/阿尔科斯/
Alkoubaiy	/阿勒库巴伊/
Alkoulombre	/阿尔库隆布尔/
Alkovic	/阿尔科维奇/
Alksnis	/阿尔克斯尼斯/
Alksten	/阿尔克斯滕/
Alku	/阿尔库/
Alkula	/阿尔库拉/
Alkunen	/阿尔库宁/
Alkusevic	/阿尔库舍维奇/
Alkusevski	/阿尔库舍夫斯基/
Alkushevic	/阿尔库舍维奇/
Alkushevski	/阿尔库舍夫斯基/
Alkut	/阿尔库特/
Alkvist	/阿尔奎斯特/
All	/阿尔/奥尔/
Alla	/阿拉/
Allab	/阿拉/
Allabashi	/阿拉巴希/
Allaben	/阿拉本/
Allaberdy	/阿拉别尔德/
Allaberdyev	/阿拉别尔德耶夫/
Allabergenov	/阿拉别尔格诺夫/
Allabert	/阿拉贝尔/
Allabo	/阿拉布/
Allaboh	/阿拉博/
Allaci	/阿拉奇/
Alladin	/阿利亚丁/
Allado	/阿利亚多/
Allaer	/阿拉尔/
Allaert	/阿拉尔/
Allaf	/阿拉夫/
Allafi	/阿拉菲/
Allafort	/阿拉福尔/
Allaga	/奥洛高/
Allagany	/拉贾尼/
Allage	/阿拉热/
Allagnon	/阿拉尼翁/
Allagrand	/阿拉格朗/
Allah	/阿拉/
Allahbuksh	/阿拉布克什/
Allahou	/阿拉胡/
Allahoum	/阿拉胡姆/
Allahvardi	/阿拉瓦尔迪/
Allaigre	/阿莱格尔/
Allaili	/阿拉伊利/
Allain	/阿拉因/阿兰/
Allaines	/阿莱纳/
Allainmat	/阿兰马/
Allaire	/阿莱尔/
Allais	/阿莱/
Allaix	/阿莱/
Allakai	/阿拉凯/
Allakherdi	/阿拉赫尔季/
Allakhveran	/阿拉赫韦兰/
Allakhverd	/阿拉赫韦尔德/
Allakhverdiev	/阿拉赫韦尔季耶夫/
Allakhverdiyev	/阿拉赫韦季耶夫/
Allakhverdov	/阿拉赫韦尔多夫/
Allakhverdyan	/阿拉赫韦尔江/
Allakulovich	/阿拉库洛维奇/
Allal	/阿拉尔/阿拉勒/
Allalde	/阿利亚尔德/
Allali	/阿拉利/
Allam	/阿拉姆/
Allam-Mi	/阿拉米/
Allama	/阿拉马/
Allamagny	/阿拉马尼/
Allamand	/阿拉芒/
Allamargot	/阿拉马戈/
Allamasse	/阿拉马塞/
Allamigeon	/阿拉米容/
Allamurad	/阿拉穆拉德/
Allamy	/阿拉米/
Allan	/阿兰/阿伦/艾伦/
Allana	/阿拉纳/
Allance	/阿伦斯/
Allanche	/阿朗什/
Allande	/阿兰德/
Allander	/阿兰德/
Allaneau	/阿拉诺/
Allanegui	/阿利亚内吉/
Allanet	/阿拉内/阿利亚内特/
Allani	/阿拉尼/
Allanic	/阿拉尼克/
Allanmaa	/阿兰马/
Allanno	/阿拉诺/
Allanot	/阿拉诺/
Allanou	/阿拉努/
Allanson	/阿兰森/阿兰松/
Allansson	/阿兰松/
Allant	/阿朗/
Allantaz	/阿朗塔/
Allaoua	/阿拉瓦/
Allaout	/阿拉乌特/
Allara	/阿利亚拉/
Allard	/阿拉德/阿拉尔/阿利亚德/
Allardi	/阿拉迪/
Allardice	/阿拉迪斯/阿勒代斯/阿利亚迪塞/
Allardin	/阿拉丹/
Allardt	/阿拉特/
Allardyce	/阿勒代斯/
Allari	/阿拉里/
Allarousse	/阿拉鲁斯/
Allart	/阿拉尔/阿拉特/
Allary	/阿拉里/
Allas	/阿拉/阿拉斯/阿利亚斯/
Allason	/阿拉森/
Allassani	/阿拉萨尼/
Allassounouma	/阿拉苏努马/
Allat	/阿勒特/
Allaud	/阿洛/
Allauddin	/阿拉丁/
Allaudin	/阿拉丁/
Allaume	/阿洛姆/
Allaun	/阿朗/
Allaux	/阿洛/
Allauze	/阿洛兹/
Allauzen	/阿洛藏/
Allavala	/阿拉瓦拉/
Allavena	/阿拉韦纳/
Allavene	/阿拉韦纳/
Allaverdyan	/阿拉韦尔江/
Allavoine	/阿拉瓦纳/
Allaway	/阿拉韦/
Allayar	/阿拉亚尔/
Allayarov	/阿拉亚罗夫/
Allbaugh	/奥尔博/
Allbeck	/奥尔贝克/
Allberg	/阿尔贝里/
Allblom	/阿尔布卢姆/
Allborg	/阿尔堡/
Allbrandt	/阿尔布兰特/
Allbring	/阿尔布林/
Allbrink	/阿尔布林克/
Allbutt	/奥尔伯特/
Allchin	/奥尔欣/
Allcomerz	/阿利科梅斯/
Allcos	/阿尔科斯/
Allcroft	/奥尔克罗夫特/
Allcut	/奥尔克特/
Alldag	/阿尔达格/
Allde	/阿尔德/
Allden	/阿尔登/
Allder	/阿尔德/
Alldredge	/奥尔德雷奇/
Alle	/阿勒/奥勒/
Alleas	/阿莱亚/
Alleau	/阿洛/
Alleaume	/阿洛姆/
Allebro	/阿莱布罗/
Allec	/阿莱克/
Alledal	/阿莱达尔/
Allee	/阿莱/阿利/
Alleen	/阿伦/
Alleg	/阿莱格/
Allegaert	/阿勒盖特/
Allegatiere	/阿莱加蒂埃/
Allegot	/阿莱戈/
Allegraud	/阿莱格罗/
Allegre	/阿莱格尔/
Allegret	/阿莱格雷/
Allegretti	/阿莱格雷蒂/
Allegri	/阿莱格里/
Allegrier	/阿莱格里耶/
Allegrini	/阿莱格里尼/
Allegro	/阿莱格罗/阿列格罗/
Allegue	/阿列格/
Allehaut	/阿莱奥/
Alleholm	/阿莱霍尔姆/
Allein	/阿兰/
Alleine	/阿林/
Allekotte	/阿莱科特/阿勒科特/
Allele	/阿莱莱/
Allely	/阿勒利/
Allem	/阿朗/阿利姆/
Allemagne	/阿勒马涅/
Alleman	/阿莱曼/阿勒曼/
Allemand	/阿莱曼德/阿勒芒/
Allemandet	/阿勒芒代/
Allemane	/阿勒马纳/
Allemang	/阿利芒/
Allemann	/阿勒曼/
Allemano	/阿莱马诺/阿利马诺/
Allemant	/阿勒芒/
Allemes	/阿勒梅/
Allemon	/阿勒蒙/
Allemoz	/阿勒莫/
Allen	/阿朗/阿连/阿伦/艾伦/
Allenbach	/阿朗巴克/阿伦巴赫/
Allenberg	/阿伦贝里/
Allenbert	/阿伦贝特/
Allenby	/艾伦比/
Allenc	/阿朗/
Allendale	/艾伦代尔/
Allende	/阿连德/
Allendes	/阿连德斯/
Allendesalazar	/阿连德萨拉萨尔/
Allendez	/阿连德斯/
Allendoerfer	/艾伦多弗/
Allendorf	/阿伦多夫/
Allendorff	/阿伦多夫/
Allenet	/阿勒内/
Allenius	/阿莱纽斯/
Allenmark	/阿伦马克/
Alleno	/阿勒诺/
Allenou	/阿勒努/
Allenov	/阿列诺夫/
Allens	/阿朗/
Allenstein	/阿伦施泰因/
Alleonard	/阿莱奥纳尔/
Alleoud	/阿莱乌/
Allepuz	/阿列普斯/
Aller	/阿莱/阿勒/阿列尔/
Allera	/阿莱拉/
Alleram	/奥莱劳姆/
Allerat	/阿莱拉/
Allerbeck	/阿勒贝克/
Allerberg	/阿勒贝里/
Allerborg	/阿勒堡/
Allerborn	/阿勒博恩/
Allerdahl	/阿勒达尔/
Alleres	/阿利耶尔/
Allerfors	/阿勒福什/
Allergan	/阿勒根/
Allergard	/阿勒高/
Allergren	/阿勒格伦/
Allerhand	/阿勒汉德/
Allermann	/阿勒曼/
Allermark	/阿勒马克/
Allerme	/阿莱尔姆/
Allermo	/阿勒莫/
Allern	/阿莱恩/
Allernas	/阿勒内斯/
Alleron	/阿勒龙/
Allers	/阿勒斯/
Allersand	/阿勒桑德/
Allerskog	/阿勒斯科格/
Allerslev	/阿勒斯莱乌/
Allerstam	/阿勒斯坦/
Allerstedt	/阿勒斯泰特/
Allerstig	/阿勒斯蒂格/
Allerstrand	/阿勒斯特兰德/
Allert	/阿莱特/阿勒特/
Allerth	/阿勒特/
Allerton	/阿勒顿/
Allerud	/阿莱鲁德/
Allerup	/奥尔勒普/
Alleryd	/阿莱吕德/
Alles	/阿莱/阿勒斯/阿列斯/
Allesch	/阿勒施/
Allese	/阿莱塞/
Allesiardi	/阿莱西亚尔迪/
Allesley	/奥尔斯利/
Allesson	/阿莱松/
Allest	/阿莱斯特/
Allestedt	/阿莱斯泰特/
Allestree	/阿莱斯特里/阿利斯里/
Allesz	/奥莱斯/
Allet	/阿莱/
Alleton	/阿勒东/
Alletti	/阿莱蒂/
Allevad	/阿莱瓦德/
Allevard	/阿勒瓦尔/
Allevato	/阿莱瓦托/
Allevi	/阿列维/
Alleweldt	/阿勒韦尔特/
Allex	/阿莱/
Alley	/阿利/
Alleyn	/阿莱恩/
Alleyne	/阿莱恩/阿列内/
Alleyrac	/阿莱拉克/
Allez	/阿莱/阿列斯/
Allezaix	/阿勒泽/
Alleze	/阿勒策/
Allfors	/阿尔福什/
Allfrey	/奥尔弗里/
Allgaeuer	/阿尔戈伊尔/
Allgaier	/阿尔盖尔/奥尔盖耶/
Allgardh	/阿尔高/
Allgauer	/阿尔戈伊尔/
Allgayer	/阿尔盖尔/
Allgeier	/阿尔盖尔/奥尔盖耶/
Allgen	/阿尔根/
Allgeyer	/阿尔热耶/
Allgood	/奥尔古德/
Allgoth	/阿尔戈特/
Allgren	/阿尔格伦/
Allgulander	/阿尔古兰德/
Allgulin	/阿尔古林/
Allguren	/阿尔古伦/
Allgurin	/阿尔古林/
Allhagen	/阿尔哈根/
Allhammar	/阿尔哈马尔/
Allhausen	/阿尔豪森/
Allheden	/阿尔赫登/
Allhusen	/阿尔休森/
Alli	/阿利/埃利/
Allia	/阿利亚/
Alliali	/阿利亚利/
Alliany	/阿利亚尼/
Allianz	/阿利昂/
Alliard	/阿利亚尔/
Allias	/阿利亚/
Alliaume	/阿利奥姆/
Allibert	/阿利贝尔/
Allibhoy	/阿利沃伊/
Allibone	/阿利本/
Allica	/阿利卡/
Allidier	/阿利迪耶/
Allie	/阿利/
Alliegro	/阿列格罗/
Alliel	/阿利耶尔/
Allien	/阿利安/
Alliende	/阿连德/
Allier	/阿利耶/
Allies	/阿莱斯/阿利/阿利耶斯/
Alliesse	/阿利耶斯/
Alliez	/阿利耶/
Alligand	/阿利冈/
Allighan	/阿利根/
Alligier	/阿利吉耶/
Allignet	/阿利涅/
Allignol	/阿利尼奥尔/
Alligot	/阿利戈/
Alligre	/阿利格尔/
Allik	/阿利克/
Allilaire	/阿利莱尔/
Allili	/阿利利/
Alliluyev	/阿利卢耶夫/
Alliluyeva	/阿利卢耶娃/
Allimant	/阿利芒/
Allin	/阿林/
Allinc	/阿兰/
Alline	/阿利纳/
Allinei	/阿利内/
Allinen	/阿利宁/
Alling	/阿林/
Allinge	/阿林格/
Allinger	/阿林格/阿林格尔/
Allingham	/阿林厄姆/
Allinquant	/阿兰康/
Allinson	/阿林森/
Allioglu	/阿尔勒奥卢/
Allioli	/阿廖利/
Allioni	/阿廖尼/
Alliot	/阿利奥/
Alliott	/阿利奥特/
Allioub	/阿利乌/
Allioux	/阿利乌/
Alliqer	/阿利克/
Alliqerova	/阿利克罗娃/
Allirol	/阿利罗尔/
Allis	/阿利/阿利斯/
Allison	/阿莉森/阿利森/
Allister	/阿利斯特/
Allisto	/阿利斯托/
Alliston	/阿利斯顿/
Allisy	/阿利西/
Allix	/阿利克斯/
Allizart	/阿利扎尔/
Allizon	/阿利宗/
Alljar	/阿利哈尔/
Alljarcio	/阿利哈西奥/
Allkemper	/阿尔肯佩/
Allkofer	/阿尔科费尔/
Allmacher	/阿尔马赫/
Allman	/奥尔曼/
Allmand	/奥尔芒/
Allmann	/阿尔曼/
Allmen	/阿尔芒/阿尔门/
Allmenroder	/阿尔门勒德/
Allmer	/阿尔默/
Allmers	/阿尔默斯/
Allmich	/阿尔米希/
Allmon	/阿利蒙/
Allner	/阿尔纳/奥尔纳/
Allnoch	/阿尔诺赫/
Allo	/阿略/阿洛/
Alloard	/阿洛阿尔/
Alloatti	/阿略瓦蒂/阿洛阿蒂/
Allobroges	/阿洛布罗热/
Alloca	/阿略卡/
Allocco	/阿略科/阿洛科/
Allocer	/阿略塞尔/
Allochon	/阿洛雄/
Allodi	/阿略迪/阿洛迪/
Allodiatoris	/奥洛迪奥托里什/
Allofs	/阿洛夫斯/
Allogne	/阿洛涅/
Alloin	/阿卢安/
Allois	/阿卢瓦/
Alloiteau	/阿卢瓦托/
Allon	/阿隆/
Allona	/阿略纳/
Allonas	/阿洛纳/
Allonca	/阿利翁卡/
Alloncle	/阿隆克勒/
Allonen	/阿洛宁/
Allongue	/阿隆格/
Allonneau	/阿洛诺/
Allonzot	/阿隆佐/
Allorant	/阿洛朗/
Allorent	/阿洛朗/
Allorge	/阿洛尔热/
Allori	/阿洛里/
Allory	/阿洛里/
Allot	/阿略特/阿洛/阿洛特/
Allotru	/阿洛特吕/
Allott	/阿洛特/
Allouache	/阿卢阿什/
Allouant	/阿卢旺/
Allouard	/阿卢阿尔/
Allouche	/阿卢什/
Allouchery	/阿卢舍里/
Alloueteau	/阿卢埃托/
Allouette	/阿卢埃特/
Allouetteau	/阿卢埃托/
Allouez	/阿卢埃/
Allouf	/阿卢夫/
Allouis	/阿卢伊/
Alloul	/阿卢尔/阿卢勒/
Allouna	/阿卢纳/
Allounini	/阿卢尼尼/
Allouti	/阿卢蒂/
Alloy	/阿洛伊/
Alloyau	/阿卢瓦约/
Alloyeau	/阿卢瓦约/
Alloys	/阿卢瓦/
Alloza	/阿略萨/
Allport	/奥尔波特/
Allram	/阿尔拉姆/
Allray	/阿尔雷/
Allred	/奥尔雷德/
Allridge	/奥尔里奇/
Allroggen	/阿尔罗根/
Allroth	/阿尔罗特/
Allsebrook	/奥尔斯布鲁克/
Allsing	/阿尔辛/
Allsman	/奥尔斯曼/
Allson	/奥尔森/
Allsop	/奥尔索普/
Allsopp	/奥尔索普/
Allspach	/阿尔施帕赫/
Allston	/奥尔斯顿/
Allstrin	/阿尔斯特林/
Allt	/奥尔特/
Allu	/阿留/
Alluard	/阿吕阿尔/
Alluchon	/阿吕雄/
Allue	/阿留韦/阿吕/
Allueva	/阿留韦瓦/
Alluin	/阿吕安/
Alluitte	/阿吕特/
Allum	/阿勒姆/
Allvar	/阿尔瓦/阿尔瓦尔/
Allve	/阿利韦/
Allven	/阿尔文/
Allvin	/阿尔温/
Allvine	/奥尔文/
Allweiler	/阿尔魏勒/
Allwin	/阿尔温/
Allwohn	/阿尔沃恩/
Allwood	/奥尔伍德/
Allworden	/阿尔沃登/
Allworthy	/奥尔沃西/
Allwright	/奥尔赖特/
Ally	/阿利/艾利/
Allyn	/阿林/
Allyns	/阿兰/
Allyot	/阿利约/
Allyson	/阿利森/
Allzen	/阿尔森/
Alm	/阿尔姆/
Alma	/阿尔玛/阿尔马/
Almaas	/阿尔莫斯/
Almac	/阿尔马奇/
Almaca	/阿尔马萨/
Almack	/奥尔马克/
Almaco	/阿尔马索/
Almada	/阿尔马达/
Almadai	/阿尔马代/
Almaden	/阿尔马登/
Almadi	/阿尔马迪/奥尔马迪/
Almadrasi	/阿勒马德拉西/
Almadro	/阿尔马德罗/
Almady	/奥尔马迪/
Almaev	/阿尔马耶夫/
Almager	/阿尔玛杰/
Almagia	/阿尔马贾/阿尔马希亚/
Almagor	/阿尔马戈/
Almagro	/阿尔马格罗/
Almaguer	/阿尔马格尔/
Almai	/奥尔毛伊/
Almain	/阿尔曼/
Almajan	/阿尔默然/
Almajano	/阿尔马哈诺/
Almajanu	/阿尔马扎努/
Almajeanu	/阿尔马热亚努/
Almakaev	/阿尔马卡耶夫/
Almakayev	/阿尔马卡耶夫/
Almakunov	/阿尔马库诺夫/
Almaleh	/阿尔马莱赫/
Almamy	/阿尔马米/
Alman	/阿尔曼/奥尔曼/
Almanbet	/阿尔曼别特/
Almanca	/阿尔曼萨/
Almanco	/阿尔曼索/
Almand	/奥尔芒/
Almandoz	/阿尔曼多斯/
Almandros	/阿尔曼德罗斯/
Almani	/阿尔马尼/
Almanik	/阿尔马尼克/
Almann	/阿尔曼/
Almansa	/阿尔曼萨/
Almanso	/阿尔曼索/
Almansor	/曼苏尔/
Almansur	/阿尔曼苏尔/
Almanya	/阿尔马尼亚/
Almanza	/阿尔曼萨/阿尔曼扎/
Almanzar	/阿尔曼萨尔/
Almanzor	/阿尔曼索尔/曼苏尔/
Almanzora	/阿尔曼索拉/
Almar	/奥尔马尔/
Almara	/阿尔马拉/
Almaran	/阿尔马兰/
Almaras	/阿尔马拉斯/
Almaraz	/阿尔马拉斯/
Almarcegui	/阿尔马塞吉/
Almarcha	/阿尔马尔查/
Almarhum	/马胡姆/
Almaric	/阿尔马里克/
Almarin	/阿尔马林/
Almario	/阿尔马里奥/
Almarjao	/阿尔马让/
Almark	/阿尔马克/
Almarza	/阿尔马萨/
Almarzo	/阿尔马索/
Almas	/阿尔马什/阿尔马斯/阿勒马斯/奥尔马什/
Almasan	/阿尔马善/
Almasanu	/阿尔默沙努/
Almashegyi	/奥尔马什海吉/
Almasi	/阿尔马希/奥尔马希/
Almasque	/阿尔马斯克/
Almassi	/奥尔马希/
Almassy	/阿尔马西/奥尔马希/
Almasy	/阿尔马西/奥尔马西/
Almaszade	/阿尔马斯扎德/
Almat	/阿尔马/
Almatov	/阿尔马托夫/
Almatovich	/阿尔马托维奇/
Almau	/阿尔毛/
Almawi	/阿勒马维/
Almay	/阿尔马伊/奥尔毛伊/
Almayev	/阿尔马耶夫/
Almayrac	/阿尔迈拉克/
Almaz	/阿尔马兹/
Almaza	/阿尔马萨/阿勒马扎/
Almazan	/阿尔马让/阿尔马桑/
Almazar	/阿尔马萨/
Almazor	/阿尔马索/
Almazora	/阿尔马索拉/
Almazov	/阿尔马佐夫/
Almazul	/阿尔马苏尔/
Almberg	/阿尔姆贝里/
Almberger	/阿尔姆贝里耶/
Almblad	/阿尔姆布拉德/
Almbladh	/阿尔姆布拉德/
Almbo	/阿尔姆博/
Almborg	/阿尔姆堡/
Almbrand	/阿尔姆布兰德/
Almby	/阿尔姆比/
Almcrantz	/阿尔姆克兰茨/
Alme	/阿尔梅/阿尔姆/
Almea	/阿尔梅亚/
Almeback	/阿尔梅贝克/
Almeblad	/阿尔梅布拉德/
Almeborg	/阿尔梅堡/
Almebrant	/阿尔梅布兰特/
Almebratt	/阿尔梅布拉特/
Almebro	/阿尔梅布罗/
Almech	/阿尔梅奇/
Almecija	/阿尔梅西哈/
Almeda	/阿尔梅达/
Almedal	/阿尔梅达尔/
Almedia	/阿尔梅迪亚/
Almedingen	/阿尔梅丁根/
Almedro	/阿尔梅德罗/
Almegard	/阿尔梅高/
Almehult	/阿尔梅胡尔特/
Almeida	/阿尔梅达/
Almeidinha	/阿尔梅迪尼亚/
Almeirante	/阿尔梅兰特/
Almeirao	/阿尔梅朗/
Almejeiras	/阿尔梅赫拉斯/
Almela	/阿尔梅拉/
Almeley	/阿姆利/
Almelius	/阿尔梅柳斯/
Almellones	/阿尔梅略内斯/
Almelund	/阿尔梅隆德/
Almemark	/阿尔梅马克/
Almen	/阿尔门/阿尔缅/
Almena	/阿尔梅纳/
Almenar	/阿尔梅纳尔/
Almenara	/阿尔梅纳拉/
Almenariz	/阿尔梅纳里斯/
Almenas	/阿尔梅纳斯/
Almenberg	/阿尔门贝里/
Almendal	/阿尔门达尔/
Almendarez	/阿尔门达雷斯/
Almendra	/阿尔门德拉/
Almendral	/阿尔门德拉尔/
Almendrales	/阿尔门德拉莱斯/
Almendras	/阿尔门德拉斯/
Almendres	/阿尔门德雷斯/
Almendro	/阿尔门德罗/
Almendros	/阿尔门德罗斯/
Almendrote	/阿尔门德罗特/
Almenov	/阿尔梅诺夫/
Almer	/阿尔梅尔/阿尔默/奥尔梅尔/
Almeras	/阿尔梅拉/
Almerborn	/阿尔默博恩/
Almerdahl	/阿尔默达尔/
Almereis	/阿尔默雷/
Almeren	/阿尔梅伦/
Almerfors	/阿尔默福什/
Almerge	/阿尔梅热/
Almerheim	/阿尔默海姆/
Almeria	/阿尔梅里亚/
Almerich	/阿尔梅里奇/
Almerin	/阿尔默林/
Almerindo	/阿尔梅林多/
Almering	/阿尔梅林/
Almerinho	/阿尔梅林霍/
Almerino	/阿尔梅里诺/
Almerius	/阿尔梅留斯/
Almero	/阿尔梅罗/
Almerova	/阿尔梅罗娃/
Almers	/阿尔默斯/
Almersand	/阿尔默桑德/
Almersjo	/阿尔默舍/
Almerstrom	/阿尔默斯特伦/
Almert	/阿尔默特/
Almes	/阿尔梅斯/
Almesjo	/阿尔梅舍/
Almeskog	/阿尔梅斯科格/
Almestad	/阿尔梅斯塔德/
Almestav	/阿尔梅斯塔夫/
Almesten	/阿尔梅斯滕/
Almestrand	/阿尔梅斯特兰德/
Almestre	/阿尔梅斯特雷/
Almetyev	/阿尔梅季耶夫/
Almeyda	/阿尔梅达/
Almeyev	/阿尔梅耶夫/
Almfalk	/阿尔姆法尔克/
Almfeldt	/阿尔姆费尔特/
Almgard	/阿尔姆高/
Almgren	/阿尔姆格伦/
Almhult	/阿尔姆胡尔特/
Almi	/阿尔米/
Almiala	/阿尔米亚拉/
Almicar	/阿尔米卡/
Almida	/阿尔米达/
Almido	/阿尔米多/
Almila	/阿尔米拉/
Almillategui	/阿尔米利亚特吉/
Almimet	/阿尔米梅/
Almin	/阿尔明/阿勒明/
Almina	/阿尔米纳/
Alminana	/阿尔米尼亚纳/
Alminder	/阿尔明德/
Almine	/阿勒明/
Alminer	/阿尔米纳/
Alming	/阿尔明/
Almingol	/阿尔明戈尔/
Alminhas	/阿尔米尼亚斯/
Almino	/阿尔米诺/
Almir	/阿尔米尔/
Almira	/阿尔迈拉/阿尔米拉/
Almirall	/阿尔米拉利/
Almirante	/阿尔米兰特/
Almiro	/阿尔米罗/
Almiron	/阿尔米龙/
Almisas	/阿尔米萨斯/
Almkleven	/阿尔姆克莱文/
Almklint	/阿尔姆克林特/
Almkrantz	/阿尔姆克兰茨/
Almkvist	/阿尔姆奎斯特/
Almlid	/阿尔姆利德/
Almling	/阿尔姆林/
Almlof	/阿尔姆勒夫/
Almlov	/阿尔姆勒夫/
Almlund	/阿尔姆隆德/
Almo	/阿尔莫/
Almocim	/阿尔莫辛/
Almocovar	/阿尔莫科瓦尔/
Almodavar	/阿尔莫达瓦尔/
Almodovar	/阿尔莫多瓦尔/
Almog	/阿尔莫格/
Almoguera	/阿尔莫格拉/
Almohalia	/阿尔莫阿利亚/
Almoina	/阿尔莫伊纳/
Almoinha	/阿尔莫伊尼亚/
Almon	/阿尔蒙/
Almonacid	/阿尔莫纳西德/
Almond	/阿尔蒙/阿尔蒙德/
Almonde	/阿尔蒙德/
Almoneda	/阿尔莫内达/
Almonia	/阿尔莫尼亚/
Almonkari	/阿尔蒙卡里/
Almono	/阿尔莫尼奥/
Almonte	/阿尔蒙特/
Almonzi	/阿尔蒙齐/
Almor	/阿尔莫/
Almoraza	/阿尔莫拉萨/
Almoril	/阿尔莫里尔/
Almoro	/阿尔莫罗/
Almoros	/阿尔莫罗斯/
Almorox	/阿尔莫罗克斯/
Almos	/阿尔莫/阿尔莫什/阿尔莫斯/
Almosdi	/阿尔莫什迪/
Almosdy	/阿尔莫什迪/
Almosnino	/阿尔莫斯尼诺/
Almoster	/阿尔莫斯特/
Almous-Tapha	/穆斯塔法/
Almoustapha	/穆斯塔法/
Almoyev	/阿尔莫耶夫/
Almoyna	/阿尔莫伊纳/
Almquist	/阿尔姆奎斯特/
Almqvist	/阿尔姆奎斯特/
Almren	/阿尔姆伦/
Almring	/阿尔姆林/
Almroos	/阿尔姆罗斯/
Almroth	/阿尔姆罗思/阿尔姆罗特/
Almsater	/阿尔姆塞特/
Almsick	/阿尔姆齐克/
Almstadt	/阿尔姆施塔特/
Almstaier	/阿尔姆施泰尔/
Almstedt	/阿尔姆施泰特/阿尔姆斯泰特/
Almstrom	/阿尔姆斯特伦/
Almstromer	/阿尔姆斯特勒默/
Almudena	/阿尔穆德纳/
Almudevar	/阿尔穆德瓦尔/
Almudi	/阿尔穆迪/
Almueis	/阿尔米埃/
Almugahed	/穆贾希德/
Almuina	/阿尔穆伊尼亚/
Almuli	/阿尔穆利/
Almuly	/阿尔米利/
Almung	/阿尔蒙/
Almunger	/阿尔蒙格/
Almunia	/阿尔穆尼亚/
Almus	/阿尔穆斯/
Almut	/阿尔穆特/
Almutawakkil	/穆塔瓦基勒/
Almuzara	/阿尔穆萨拉/
Almvall	/阿尔姆瓦尔/
Almwik	/阿尔姆维克/
Almy	/阿尔米/
Almyr	/阿尔米尔/
Alna	/阿尔纳/
Alnach	/阿尔纳赫/奥尔瑙奇/
Alnaes	/阿尔内斯/
Alnar	/阿尔纳尔/
Alnas	/阿尔内斯/
Alnaz	/阿尔纳斯/
Alndre	/阿恩德雷/
Alnebeck	/阿尔内贝克/
Alnebo	/阿尔内博/
Alnebrant	/阿尔内布兰特/
Alnell	/阿尔内尔/
Alner	/阿尔纳/
Alnered	/阿尔内雷德/
Alnerfelt	/阿尔纳费尔特/
Alnerius	/阿尔内留斯/
Alnerod	/阿尔内勒德/
Alneryd	/阿尔内吕德/
Alnes	/阿尔尼/
Alneskog	/阿尔内斯科格/
Alness	/阿尔内斯/阿尔尼斯/
Alnestam	/阿尔内斯坦/
Alngar	/阿尔恩加尔/
Alniacik	/阿尔纳阿彻克/
Alniak	/阿尔纳阿克/
Alno	/阿尔诺/
Alnor	/阿尔诺尔/
Alnot	/阿尔诺/
Alnwick	/阿尼克/
Alnyr	/阿尔尼尔/
Alo	/阿洛/
Alobera	/阿洛韦拉/
Alobic	/阿洛比奇/
Aloc	/阿勒奇/
Alocen	/阿洛森/
Aloe	/阿洛埃/
Alogan	/阿洛安/
Alogic	/阿洛吉奇/
Aloglu	/阿尔奥卢/
Alogo	/阿洛戈/
Alohana	/阿洛哈纳/
Aloici	/阿洛伊西/
Aloin	/阿卢安/
Alois	/阿卢瓦/阿洛伊斯/
Aloise	/阿卢瓦斯/阿洛伊斯/
Aloisi	/阿卢瓦西/
Aloisia	/阿洛伊西亚/
Aloisio	/阿洛伊西奥/
Aloisius	/阿洛伊修斯/
Aloizas	/阿洛伊扎斯/
Aloiziyevich	/阿洛伊济耶维奇/
Alojz	/阿洛伊兹/
Alojza	/阿洛伊扎/
Alojzije	/阿洛伊齐耶/
Alojzy	/阿洛伊齐/
Aloko	/阿洛科/
Alolf	/阿洛尔夫/
Alolga	/阿洛尔加/
Alom	/阿隆/
Aloma	/阿洛马/
Aloman	/阿洛曼/
Alomar	/阿洛马尔/
Alombard	/阿隆巴尔/
Alombert	/阿隆贝尔/
Alombrada	/阿隆布拉达/
Alomerovic	/阿洛梅罗维奇/
Alomia	/阿洛米亚/
Alomo	/阿洛莫/
Alon	/阿隆/
Aloncen	/阿隆森/
Alondiga	/阿隆迪加/
Alondo	/阿隆多/
Aloneftis	/阿洛内弗蒂斯/
Alonen	/阿洛宁/
Alongi	/阿隆吉/
Aloni	/阿洛尼/
Alonius	/阿洛纽斯/
Alonos	/阿洛诺斯/
Alonov	/阿洛诺夫/
Alonso	/阿朗索/阿隆索/
Alonto	/阿隆托/
Alony	/阿洛尼/
Alonzo	/阿朗索/阿隆索/
Alopaeus	/阿洛佩乌斯/
Aloriz	/阿洛里斯/
Aloro	/阿洛罗/
Alory	/阿洛里/
Alos	/阿洛/阿洛斯/
Alosete	/阿洛塞特/
Alosi	/阿洛西/
Alosno	/阿洛斯诺/
Aloso	/阿洛索/
Alot	/阿洛/阿洛特/
Alou	/阿卢/阿洛乌/
Alouache	/阿卢阿什/
Alouan	/阿勒万/阿洛安/
Alouche	/阿卢什/
Alouet	/阿卢埃/
Alouette	/阿卢埃特/
Alouf	/阿卢夫/
Alouie	/阿勒维/
Alouini	/阿卢尼/
Alouis	/阿路易/
Alounkeo	/阿隆乔/
Alousi	/阿卢西/
Alousque	/阿卢斯克/
Alov	/阿洛夫/
Aloviddinov	/阿洛维季诺夫/
Alovov	/阿洛沃夫/
Aloy	/阿卢瓦/
Aloyan	/阿洛扬/
Aloyau	/阿卢瓦约/
Aloys	/阿洛伊斯/
Aloysia	/阿洛伊西奥/阿洛伊西亚/
Aloysie	/阿洛伊西/
Aloysio	/阿洛伊西奥/
Aloysius	/阿洛伊修斯/
Alozie	/阿洛齐/
Alozy	/阿洛齐/
Alp	/阿尔普/
Alpa	/阿尔帕/
Alpadie	/阿尔帕迪/
Alpago	/阿尔帕戈/
Alpagut	/阿尔帕古特/
Alpaidze	/阿尔派泽/
Alpakan	/阿尔帕坎/
Alpakin	/阿尔帕肯/
Alpalhao	/阿尔帕良/
Alpaliov	/阿尔帕利奥夫/
Alpan	/阿尔潘/
Alpanda	/阿尔庞达/
Alpande	/阿尔潘德/
Alpanen	/阿尔帕宁/
Alpanes	/阿尔帕涅斯/
Alpanseque	/阿尔潘塞克/
Alpar	/阿尔帕尔/奥尔帕尔/
Alparda	/阿尔帕尔达/
Alpargun	/阿尔帕尔贡/
Alpari	/奥尔帕里/
Alparman	/阿尔帕尔曼/
Alpartun	/阿尔帕尔通/
Alpary	/奥尔帕里/
Alpas	/阿尔帕斯/
Alpaslan	/阿尔帕斯兰/
Alpass	/阿尔帕斯/奥尔帕斯/
Alpat	/阿尔帕特/
Alpatov	/阿尔帕托夫/
Alpatyev	/阿尔帕季耶夫/
Alpaut	/阿尔帕乌特/
Alpay	/阿尔帕伊/阿尔佩/
Alpaydin	/阿尔帕伊登/
Alpayer	/阿尔帕耶尔/
Alpbaz	/阿尔普巴兹/
Alpcetin	/阿尔普切廷/
Alpdemir	/阿尔普代米尔/
Alpdogan	/阿尔普多安/
Alpe	/阿尔佩/阿尔普/
Alpedal	/阿尔佩达尔/
Alpedrinha	/阿尔佩德里尼亚/
Alpek	/奥尔派克/
Alpen	/阿尔彭/
Alpendinho	/阿尔彭迪尼奥/
Alpendre	/阿尔彭德雷/
Alpendurada	/阿尔彭杜拉达/
Alpengin	/阿尔彭金/
Alper	/阿尔佩尔/阿尔珀/
Alperen	/阿尔佩伦/
Alperi	/阿尔佩里/
Alperin	/阿尔佩林/阿尔珀兰/阿尔珀林/
Alperine	/阿尔珀里娜/
Alpermis	/阿尔佩尔米什/
Alpern	/阿尔佩恩/阿尔珀恩/
Alperov	/阿尔佩罗夫/
Alperovich	/阿尔佩罗维奇/
Alpers	/阿尔佩尔斯/阿尔佩斯/阿尔珀斯/阿佩尔/
Alpert	/阿尔佩特/阿尔珀特/
Alperten	/阿尔佩尔滕/
Alperth	/阿尔佩特/
Alpertunga	/阿尔佩尔通加/
Alpes	/阿尔普/
Alpetekin	/阿尔佩泰金/
Alpeyrie	/阿尔佩里/
Alpgiray	/阿尔普吉拉伊/
Alpha	/阿尔法/
Alphaeus	/阿尔菲厄斯/
Alphan	/阿尔普汗/
Alphand	/阿尔方/
Alphandari	/阿尔方达里/
Alphandary	/阿尔方达里/
Alphandery	/阿尔方德里/
Alphe	/阿尔夫/
Alphen	/阿尔芬/
Alpheu	/阿尔费乌/
Alpheus	/阿尔菲厄斯/阿尔费乌斯/
Alphonce	/阿尔方斯/
Alphons	/阿方斯/
Alphonsa	/阿方萨/
Alphonse	/阿方斯/
Alphonsine	/阿方西娜/
Alphonso	/阿方索/
Alphonsus	/阿方萨斯/
Alphonzo	/阿方索/
Alphyddans	/阿尔皮丹斯/
Alpi	/阿尔皮/
Alpia	/阿尔皮亚/
Alpian	/阿尔皮安/
Alpiarca	/阿尔皮亚萨/
Alpierre	/阿皮埃尔/
Alpin	/阿尔平/
Alpina	/阿尔皮纳/
Alpines	/阿尔皮纳/
Alpinien	/阿尔皮尼安/
Alpino	/阿尔皮诺/
Alpis	/阿尔皮斯/
Alpisbayev	/阿尔皮斯巴耶夫/
Alpkan	/阿尔普坎/
Alpkanat	/阿尔普卡纳特/
Alpkartal	/阿尔普卡尔塔尔/
Alpkaya	/阿尔普卡亚/
Alpkin	/阿尔普肯/
Alpkoymen	/阿尔普柯伊曼/
Alplid	/阿尔普利德/
Alpman	/阿尔普曼/
Alpmann	/阿尔普曼/
Alpo	/阿尔波/
Alpogan	/阿尔波安/
Alpoim	/阿尔波因/
Alponat	/阿尔波纳特/
Alpopii	/阿尔波皮/
Alpoq	/阿尔普克/
Alport	/奥尔波特/
Alpos	/阿尔波斯/
Alposkay	/阿尔波斯卡伊/
Alppi	/阿尔皮/
Alppinen	/阿尔皮宁/
Alppivuori	/阿尔皮沃里/
Alprovitz	/阿尔普罗维茨/
Alpsan	/阿尔普桑/
Alpsar	/阿尔普萨尔/
Alpsater	/阿尔普塞特/
Alpsjo	/阿尔普舍/
Alpsokmen	/阿尔普瑟克曼/
Alpsoy	/阿尔普索伊/
Alpsoylu	/阿尔普索伊卢/
Alpstad	/阿尔普斯塔德/
Alpsten	/阿尔普斯滕/
Alpsu	/阿尔普叙/
Alptekin	/阿尔普泰金/
Alptimucin	/阿尔普蒂穆金/
Alptogan	/阿尔普托安/
Alptug	/阿尔普图/
Alpturk	/阿尔普蒂尔克/
Alptuzun	/阿尔普蒂津/
Alpun	/阿尔平/
Alpy	/阿尔皮/
Alpyildiz	/阿尔普耶尔德兹/
Alpysovna	/阿尔佩索芙娜/
Alpyurek	/阿尔普于雷克/
Alpyuruk	/阿尔普于吕克/
Alpzen	/阿尔普森/
Alquesar	/阿尔克萨尔/
Alquie	/阿尔基耶/
Alquier	/阿尔基耶/
Alrais	/拉伊斯/
Alran	/阿尔朗/
Alred	/阿尔里德/埃尔勒德/
